stress	estrés
manipulation	manipulación
unsavory	desagradable
cozy	cosy
brood	cría
usurp	usurpar
prominent	prominente
boom	auge
achievements	logros
invalidate	invalidar
jolt	sacudida
sweeping	general
farcical	absurdo
splendidly	espléndidamente
obsolete	obsoleto
loved	amado
flagging	marcar
erase	borrar
disillusions	desilusiones
negligent	negligente
adulatory	adulador
assail	atacar
slap	bofetada
agilely	ágilmente
deprave	depravar
hell-bent	empeñado
chivalry	caballería
manipulative	manipulativo
opponent	adversario
loyal	leal
vilify	vilipendiar
desirous	deseoso
evil	mal
unsettling	inquietante
brilliance	brillantez
crime	crimen
unreadable	ilegible
renowned	renombrado
fidelity	fidelidad
malignant	maligno
disaffected	desafecto
desertion	deserción
burdensomely	pesadamente
stalemate	estancamiento
simplistic	simplista
attentive	atento
helping	ayudar
idiot	idiota
astounding	impresionante
divergent	divergente
infringements	infracciones
loner	solitario
super	súper
despondence	desaliento
dies	muere
shatter	destrozar
complemented	complementado
castigate	castigar
egregious	enorme
fatuous	fatuo
stunning	maravilloso
accomplishments	logros
cleaner	limpiador
glare	deslumbramiento
blunt	embotado
rebuff	rechazo
mirage	espejismo
thoughtlessness	irreflexión
flickering	parpadeo
refund	reembolso
beauty	belleza
mysterious	misterioso
aggressive	agresivo
adorer	adorador
grudging	avaro
appallingly	horriblemente
unease	malestar
rattles	sonajas
likes	gustos
depress	deprimir
hostilities	hostilidades
limit	límite
alienation	alienación
exult	exultar
charming	encantador
languorously	langurosamente
meritorious	meritorio
unnecessary	innecesario
dust	polvo
restricted	restringido
discontinued	discontinuado
bombard	bombardear
cheats	tramposos
solace	solitud
acerbate	exacerbar
crushing	aplastante
distressingly	penosamente
pleasure	placer
tarnishing	deslustre
worrying	angustioso
engulf	tragarse
spacious	espacioso
begging	mendicidad
censure	censura
repetitive	repetitivo
gumption	agallas
winnable	ganable
steadfast	firme
revert	revertir
sufferers	enfermos
punishable	castigable
enough	suficiente
shake	sacudir
killed	matado
adroitly	diestramente
miscreant	bellaco
insightful	perspicaz
unruly	revoltoso
impeccable	impecable
woefully	lamentablemente
obstructs	obstruye
brazenness	desfachatez
sloppy	descuidado
avaricious	avaro
qualms	reparos
diffidence	timidez
awestruck	atemorizado
illegal	ilegal
eloquently	elocuentemente
dissonance	disonancia
illicit	ilícito
peeved	furioso
perturb	perturbar
utterly	absolutamente
tyrannical	tiránico
procrastinates	posterga
distress	angustia
sickness	enfermedad
astonishment	asombro
disconsolately	desconsoladamente
bum	culo
overwhelm	abrumar
amaze	asombrar
fortuitous	fortuito
misguidance	extravío
inapt	inepto
retarded	retardado
insidiously	insidiosamente
childish	infantil
deceive	engañar
support	apoyo
breakthroughs	avances
stole	estola
premeditated	premeditado
dedicated	dedicado
profane	profano
grieve	afligirse
molestation	acoso
terribly	terriblemente
calamities	calamidades
harmed	perjudicado
anxiously	ansiosamente
anxiety	ansiedad
damned	maldito
spellbound	hechizado
ho-hum	aburrida
lively	animado
demise	fallecimiento
calumniate	calumniar
throbbed	palpitaba
substantive	sustantivo
horrendous	horrendo
sobering	aleccionadora
impropriety	impropiedad
revulsive	revulsivo
scant	escaso
insecurity	inseguridad
annihilation	aniquilación
convient	práctico
offender	delincuente
inculcate	inculcar
enjoying	disfrutando
viciousness	crueldad
confess	confesar
openly	abiertamente
rigidity	rigidez
relentlessly	implacablemente
appal	espantar
lackeys	lacayos
resolute	resuelto
confounding	confusión
logical	lógico
invalidity	invalidez
cracked	agrietado
offence	delito
forbidding	prohibiendo
knock	llamar
harassed	acosado
wildly	salvajemente
antagonist	antagonista
malcontent	malcontento
disgusting	repugnante
dissension	disensión
helpless	impotente
stifling	sofocante
smiles	sonrisas
miscreants	malhechores
pitifully	lastimosamente
standstill	paralización
sensation	sensación
sporty	deportivo
litigious	litigioso
dissapointed	decepcionado
screwed	roscado
inhibition	inhibición
illusory	ilusorio
decency	decencia
fierce	feroz
fretful	irritable
bigotries	intolerancias
preeminent	preeminente
cranky	irritable
disapprove	desaprobar
starkly	crudamente
worthlessly	indignamente
trust	confianza
conceded	concedido
skepticism	escepticismo
glorify	glorificar
boisterous	bullicioso
quandary	dilema
permissible	permisible
beg	mendigar
inadequacy	insuficiencia
affection	afecto
pampered	mimado
foolish	tonto
bountiful	abundante
eventful	memorable
insidious	insidioso
subsidizes	subvenciona
marginally	ligeramente
simpler	sencillo
aggression	agresión
hating	odiando
bonny	hermoso
doggedly	tenazmente
workable	factible
clouding	opacidad
reward	recompensa
corruption	corrupción
admiringly	admirativamente
favorite	favorito
enrichment	enriquecimiento
bizarre	extraño
rape	violación
unbelievably	increíblemente
incorrigible	incorregible
meaningful	significativo
mudslinging	vilipendio
accursed	maldito
humane	humano
feverish	febril
friendly	amistoso
unsustainable	insostenible
scolding	regaño
ambiguity	ambigüedad
madness	locura
bribery	soborno
gloriously	gloriosamente
scolded	regañado
weird	extraño
villainous	villano
indecision	indecisión
semi-retarded	semi-retardado
degrading	degradante
longingly	añoranza
luxurious	lujoso
dire	calamitoso
considerate	considerado
criticize	criticar
leech	sanguijuela
trumpet	trompeta
downcast	alicaído
gleefully	alegremente
deteriorate	deteriorarse
worrier	angustiado
impulsive	impulsivo
puzzlement	perplejidad
unjustifiable	injustificable
marvelled	maravillado
farfetched	rebuscado
opportunistic	oportunista
sue	demandar
unusable	inutilizable
insecure	inseguro
wounds	heridas
cynical	cínico
eager	ansioso
reforms	reformas
sputter	chisporroteo
acerbically	mordacidad
revolutionizes	revoluciona
bleak	triste
hypocrites	hipócritas
shock	choque
impediment	impedimenta
abuses	abusos
unnatural	antinatural
horrify	horrorizar
capsize	zozobrar
outcast	marginado
sweetness	dulzura
ebullient	exuberante
bent	doblado
magnanimous	magnánimo
lunatic	lunático
imprisonment	encarcelamiento
lagged	lag
cheaply	barato
endorse	endosar
choke	estrangulación
harsh	áspero
spoiled	estropeado
smile	sonrisa
startling	asombroso
annoying	molesto
erudite	erudito
salacious	salaz
exonerate	exonerar
winning	ganadora
warp	urdimbre
revives	revive
laughable	cómico
impolitic	impolítico
outlaw	proscribir
suffocate	sofocarse
absurdity	absurdo
influential	influyente
impose	prescribir
wasteful	antieconómico
darling	querido
envious	envidioso
fallacy	falacia
shabby	lamentable
oversimplified	simplificada
favour	favorecer
pimple	espinilla
rebuke	reprensión
ambiguous	ambiguo
omit	omitir
overstated	exagerado
enervate	enervar
deficiencies	deficiencias
ailment	enfermedad
sagged	combado
corrupted	corrompido
skillfully	hábilmente
phenomenal	fenomenal
inaccurately	inexactamente
destroyer	destructor
strictly	estrictamente
bellicose	belicoso
overrun	invadir
exceeded	excedido
distorts	distorsiona
discrimination	discriminación
stability	estabilidad
happiness	felicidad
excellence	excelencia
poised	listo
inferiority	inferioridad
unfortunately	desafortunadamente
illogically	ilógicamente
over-balanced	sobre-equilibrada
infected	infectado
combative	combativo
denounce	denunciar
evasion	evasión
inestimably	inestimablemente
love	amor
kindliness	bondad
controversial	polémico
nauseate	repugnar
ineffective	ineficaz
fugitive	fugitivo
rampage	alboroto
heresy	herejía
vociferously	vociferantemente
insinuating	insinuante
deride	ridiculizar
fortune	fortuna
inglorious	ignominioso
enthrall	cautivar
crabby	malhumorados
inflated	inflado
judder	vibración
grouse	queja
overwhelms	abruma
antagonistic	antagónico
lacks	carece
toil	trabajo
strange	extraño
fantastically	fantásticamente
suitable	adecuado
divisiveness	divisionismo
regressive	regresivo
emaciated	demacrado
chaotic	caótico
congratulate	felicitar
threat	amenaza
charisma	carisma
deprived	privado
rejecting	rechazando
euphorically	eufóricamente
funnily	cómicamente
criticism	crítica
respectful	respetuoso
confused	confundido
exaggerate	exagerar
advocates	defensores
struggling	luchando
animosity	animosidad
impartiality	imparcialidad
exagerated	exagerada
roomy	espacioso
beckoned	señas
freeze	congelar
conspiratorial	conspirador
hideousness	fealdad
shockingly	espantosamente
womanizer	mujeriego
scrambled	revuelto
farcically	grotescamente
futility	futilidad
cripples	lisiados
rampant	rampante
nebulously	vagamente
stricken	afligido
passion	pasión
eminent	eminente
hopelessness	desesperación
luckier	suerte
unusably	inutilizable
ameliorate	mejorar
idiots	idiotas
solemn	solemne
cajole	engatusar
prosper	prosperar
smart	inteligente
awesomely	impresionantemente
handsome	guapo
exhilarate	regocijar
steep	empinado
dissent	disidencia
bereavement	duelo
unfavorable	desfavorable
inadequate	insuficiente
smells	olores
flaking	descamación
elegant	elegante
altercation	altercado
craftily	astutamente
instigators	instigadores
zombie	zombi
lengthy	largo
mediocrity	mediocridad
restructure	reestructurar
futuristic	futurista
improving	mejorar
decry	censurar
fateful	fatídico
pout	abadejo
revolutionize	revolucionar
progressive	progresivo
defile	profanar
revelation	revelación
jarring	discorde
unilateralism	unilateralismo
uplifting	inspirador
bastard	bastardo
superiority	superioridad
ridicules	burlas
blundering	torpe
jittery	nervioso
refutation	refutación
grossly	gravemente
neurotically	neuróticamente
exquisite	exquisito
lawless	ilegal
flicker	parpadeo
overtaken	superado
crumble	desmoronarse
unacceptable	inaceptable
indulgent	indulgente
courage	coraje
ruts	roderas
smoothes	alisa
unfounded	infundado
incessantly	incesantemente
friendliness	amabilidad
shortage	escasez
entrancing	fascinante
despoiler	despojador
fuck	joder
ideally	idealmente
amazed	asombrado
dissuasive	disuasivo
illegally	ilegalmente
irritation	irritación
steadfastness	firmeza
angrily	airadamente
vestiges	vestigios
thrive	prosperar
tamper	antisabotaje
scorchingly	abrasadoramente
hell	infierno
tacky	pegajoso
polished	pulido
shortcomings	deficiencias
miserable	desgraciado
grimace	mueca
merciful	misericordioso
pardon	perdón
discourteously	descortesía
improves	mejora
beneficent	benéfico
breakups	rupturas
squeal	chillido
exceedingly	excesivamente
fiery	ardiente
apotheosis	apoteosis
recovery	recuperación
nebulous	nebuloso
amply	ampliamente
dominated	dominado
plentiful	abundante
ineffectualness	ineficacia
polluters	contaminadores
flourish	florecer
sting	picadura
admonishment	amonestación
fascination	fascinación
sane	cuerdo
distracting	distracción
awsome	impresionante
deservedly	merecidamente
astonishingly	asombrosamente
lighter	encendedor
inadvisable	desaconsejable
disloyalty	deslealtad
impresses	impresiona
solidarity	solidaridad
zenith	cenit
thoughtfully	pensativamente
blurred	borrosa
overtook	superó
disapointing	decepcionante
undersized	insuficiente
subsidized	subvencionado
fanatical	fanático
unsafe	inseguro
insatiable	insaciable
sham	impostor
isolated	aislado
hoax	engaño
losing	perder
humiliate	humillar
melancholy	melancolía
baseless	infundado
lawfully	legalmente
funky	miedoso
insultingly	insultantemente
majestic	majestuoso
upscale	lujo
mulish	terco
perfunctory	superficial
brash	temerario
diabolical	diabólico
charismatic	carismático
romantic	romántico
light-hearted	alegre
fatigue	fatiga
intimidating	intimidante
self-determination	autodeterminación
ineptly	ineptitud
sensational	sensacional
backwardness	atraso
fluster	aturdir
manipulate	manipular
expired	caducado
chaos	caos
motionless	inmóvil
antithetical	antitético
plot	parcela
outstandingly	sobresalientemente
refuted	refutado
calumniously	calumniosa
faithfulness	fidelidad
rumbling	retumbante
whore	puta
harmony	armonía
snagging	enganches
falsehood	falsedad
subtract	sustraer
worst	peor
self-destructive	autodestructivo
delayed	retrasado
impudently	impudentemente
worn	usado
mortified	mortificado
gripe	queja
racism	racismo
demonizes	demoniza
advantageously	ventajosamente
jaw-dropping	asombroso
objectionable	objetable
dexterous	diestro
gainful	remunerativo
mournful	triste
hedge	cobertura
ruffle	volante
unnervingly	desconcertantemente
grudge	rencor
overdo	exagerar
mortifying	mortificante
irk	fastidiar
fraudulent	fraudulento
disgusted	disgustado
anemic	anémico
relentlessness	implacabilidad
belittled	menospreciado
gibe	burla
torment	tormento
hallowed	santificado
illiterate	analfabeto
cuteness	monería
praiseworthy	loable
blessing	bendición
sweaty	sudoroso
gnawing	roer
dote	adorar
collude	confabularse
breakthrough	ruptura
obsess	obsesionar
catastrophes	catástrofes
spurn	desdeñar
remorseless	implacable
unimaginably	inimaginablemente
invincibility	invencibilidad
ambitious	ambicioso
blasphemous	blasfemo
joker	comodín
disapointed	decepcionado
dejection	abatimiento
demolisher	demoledor
ironies	ironías
thwart	frustrar
laud	alabar
amiable	amable
inordinately	desmesuradamente
refuting	refuta
beneficial	sano
inhumane	inhumano
infuriate	enfurecer
excellently	excelentemente
perplexity	perplejidad
bumps	golpes
immorality	inmoralidad
compulsion	compulsión
fawningly	servilmente
ardent	ardiente
rascals	bribones
confuses	confunde
frightful	espantoso
cold	frío
interfere	interferir
freakishly	monstruosamente
limits	límites
messy	confuso
shine	brillo
ineligible	inelegible
splitting	división
fatefully	fatídicamente
fragmented	fragmentado
fragrant	fragante
supreme	supremo
biting	mordaz
pervert	pervertido
illumine	iluminar
eccentric	excéntrico
rattle	sonajero
laconic	lacónico
congested	congestionado
fraud	fraude
unyielding	inflexible
destitution	miseria
conservative	conservador
scam	estafa
decadent	decadente
brazenly	descaradamente
mercy	misericordia
shortsightedness	miopía
condemned	condenado
dumbfounded	estupefacto
exemplary	ejemplar
spoon-feed	mimar
feckless	irresponsable
survival	supervivencia
fucking	jodido
clogs	zuecos
wins	victorias
kooky	excéntrica
self-criticism	autocrítica
decayed	deteriorado
dispirit	desalentar
spook	espectro
festive	festivo
dismally	tristemente
denies	niega
insufficient	insuficiente
dependably	fiable
outbreak	brote
contrive	idear
confidence	confianza
adversary	adversario
stabilize	estabilizar
worrisome	inquietante
lovely	precioso
spectacularly	espectacularmente
enrage	enfurecer
breeze	brisa
god-awful	espantoso
irritably	irritado
vomiting	vómitos
offenses	delitos
adamantly	inflexiblemente
admirably	admirablemente
desolately	tristemente
dogmatic	dogmático
condemnation	condenación
deluge	diluvio
retard	retardar
suicidal	suicida
bore	taladro
hypocrisy	hipocresía
ineptitude	ineptitud
dropouts	abandonos
brute	bruto
frenetic	frenético
richness	riqueza
bother	molestar
rip	rasgón
flickers	parpadeos
tantalize	atormentar
meddle	entrometerse
extravagance	extravagancia
naive	ingenuo
dominates	domina
gimmicks	trucos
jitters	nervios
dismayed	consternados
unparalleled	incomparable
fancy	fantasía
heroically	heroicamente
awfully	terriblemente
incommensurate	inconmensurable
versatility	versatilidad
disappointments	decepciones
deference	deferencia
imprecisely	imprecisa
unabashed	desvergonzado
monstrous	monstruoso
gratify	satisfacer
credulous	crédulo
fastuous	fastuoso
dull	aburrido
well-being	bienestar
dictator	dictador
asinine	asnal
gains	prima
quack	charlatán
stimulative	estimulante
balk	obstáculo
friction	fricción
fussy	quisquilloso
strong	fuerte
modest	modesto
limp	cojear
deceptively	engañosamente
despairingly	desesperadamente
depraved	depravado
monstrously	monstruosamente
bothering	molesto
deceivers	engañadores
indiscriminately	indiscriminadamente
harasses	acose
imaginary	imaginario
commendable	recomendable
darkened	oscurecido
gruff	brusco
scratchy	chirriante
procrastinate	aplazar
moribund	moribundo
bonuses	bonificaciones
blistering	abrasador
maliciousness	malicia
liberty	libertad
merciless	despiadado
disown	repudiar
heartfelt	cordial
downturn	recesión
elimination	eliminación
desirable	deseable
judders	vibra
sincerely	sinceramente
tangle	maraña
disavow	desautorizar
horde	horda
overture	obertura
evils	males
intimidate	intimidar
suppress	suprimir
disappointment	decepción
famous	famoso
cheat	engañar
precariously	precariamente
screw-up	tornillo-up
saintliness	santidad
polemize	polemizar
jeering	burlas
backbiting	murmuración
astounded	asombrado
wound	herida
mockeries	burlas
cruelties	crueldades
haywire	loco
recourses	recursos
peevish	malhumorado
bias	parcialidad
pleas	súplicas
advantageous	ventajoso
bewilderment	asombro
destructive	destructivo
lies	mentiras
cooperatively	cooperativamente
attractively	atractivamente
suspect	sospechoso
whoa	hala
calumniation	calumnia
irrationality	irracionalidad
assuredly	ciertamente
unsettled	inestable
upsetting	molesto
frictions	fricciones
vomit	vómito
imperious	imperioso
deteriorating	deterioro
stylishly	elegantemente
detachable	desmontable
agile	ágil
uncooperative	incooperativo
tense	tenso
confined	confinado
deceitfulness	engaño
writhe	retorcerse
disorder	trastorno
famously	famosamente
blissfully	felizmente
enraged	enfurecido
intelligence	inteligencia
contravene	infringir
frazzled	agotado
supurb	increíble
remarkably	extraordinariamente
deign	dignarse
overact	sobreactuar
loathsomely	repugnantemente
stun	aturdir
keen	humos
corrosive	corrosivo
smug	presumido
dauntless	impávido
abominably	abominablemente
stumped	sacado
harassment	acoso
delectable	deleitable
efficiently	eficientemente
critics	críticos
unseemly	impropio
retreat	retiro
whoooa	hala
exasperation	exasperación
hectic	frenético
funny	divertido
endearing	entrañable
easygoing	acomodadizo
stumps	tocones
protection	protección
inconceivably	inconcebiblemente
languish	languidecer
ineffectiveness	inoperancia
refusing	negándose
mendacity	mendacidad
manageable	manejable
insult	insulto
despondent	abatido
forswear	abjurar
amazingly	asombrosamente
trump	triunfo
complex	complejo
chaste	casto
shameful	vergonzoso
fertile	fértiles
admonition	advertencia
seething	hirviente
fondness	afición
lurid	espeluznante
stimulates	estimula
shamelessness	desvergüenza
losses	pérdidas
dawdle	holgazanear
appreciative	apreciativo
demonized	demonizado
slow	lento
hazy	brumoso
screwy	absurdo
convenience	conveniencia
unable	incapaz
overstate	exagerar
lazy	perezoso
unresponsive	insensible
fanatic	fanático
picky	exigente
mocked	burlado
demoralize	desmoralizar
irreconcilable	irreconciliable
ecstatically	éxtasis
hardy	resistente
greatness	grandeza
hypocritical	hipócrita
energetic	energético
flutter	aleteo
regretted	lamentar
caustic	cáustico
tediously	tediosamente
soreness	dolor
loot	botín
wretch	desgraciado
displeased	disgustado
degrade	degradar
wobbles	bamboleos
haggard	ojeroso
mystify	mistificar
banishment	destierro
avidly	ávidamente
subpoena	citación
malaise	malestar
disdained	desdeñado
self-sufficient	autosuficiente
sluggish	lento
contemptuous	despreciativo
detested	detestado
scams	estafas
intuitive	intuitivo
patronize	patrocinar
deploring	deplorando
ramshackle	desvencijado
cloud	nube
stereotypical	estereotipada
fallacious	erróneo
discrepant	discrepante
crack	grieta
knife	cuchillo
unconditional	incondicional
obsession	obsesión
lacked	carecido
incoherence	incoherencia
implication	implicación
reforming	reformando
prefer	preferir
thrift	ahorro
treason	traición
altruistic	altruista
incomprehension	incomprensión
devilry	diablura
haggle	regatear
traumatically	traumáticamente
groundbreaking	innovador
substandard	deficiente
inefficacy	ineficacia
alluringly	seductoramente
euphoria	euforia
disaffirm	testar
involuntary	involuntario
impudent	impudente
mangle	exprimidor
regress	retroceder
goofy	mentecato
deformed	deformado
frantically	frenéticamente
poeticize	poetizar
misguided	equivocado
inflammation	inflamación
disorient	desorientar
hug	abrazo
liar	mentiroso
terribleness	terribilidad
plague	plaga
matte	mate
frenetically	frenéticamente
joy	alegría
sack	saco
disparaging	despectivo
ingenuously	ingenuamente
contend	contender
autocratic	autocrático
weakening	debilitación
enticing	tentador
astutely	astutamente
idealize	idealizar
mischievously	maliciosamente
collapse	colapso
muddle	embrollo
fastidiously	fastidiosamente
convoluted	complejo
lackey	lacayo
dump	vertedero
contentious	contencioso
drips	goteos
desiccated	desecado
stainless	inoxidable
pride	orgullo
sardonically	sardónicamente
garbage	basura
disunity	desunión
dumb	mudo
malevolent	malévolo
fiend	demonio
repulsed	repelido
congenial	agradable
condemn	condemi
illusion	espejismo
clash	choque
intelligible	inteligible
nuisance	molestia
sweeten	dulce
irredeemable	irredimible
wearisome	aburrido
incredulous	incrédulo
flake	escama
sturdy	robusto
wariness	cautela
hospitable	hospitalario
choleric	colérico
exasperated	exasperada
immoral	inmoral
irately	airadamente
amenity	amenidad
brutalizing	embrutecedor
enlighten	iluminar
punch	ponche
mind-blowing	alucinante
ill-mannered	maleducado
deceitfully	engañosamente
pains	esfuerzos
clears	ocurre
remorse	remordimiento
fuss	bulla
concessions	concesiones
fanatically	fanáticamente
worsening	empeoramiento
retract	retraer
vicious	vicioso
healthy	saludable
condemns	condena
wow	sorprender
scarily	aterradoramente
complicit	complicita
job-killing	trabajo-matanza
muddy	fangoso
bumping	chocar
magnanimously	magnánimamente
miserly	avaro
receptive	receptivo
misunderstanding	malentendido
pariah	paria
sorry	triste
restriction	restricción
plunder	saqueo
distressing	angustioso
innovative	innovador
vice	vicio
idiocy	idiotez
thoughtful	pensativo
gossip	chismes
intrusive	intruso
oddities	rarezas
taboo	tabú
delighted	encantado
dense	compacto
promises	promesas
frustrated	frustrado
fabulously	fabulosamente
shrill	estridente
revengeful	vengativo
pry	palanca
plaything	juguete
fat	grasa
selective	selectivo
appropriate	apropiado
dejected	abatido
self-humiliation	auto-humillación
remorselessness	implacabilidad
unexpectedly	inesperadamente
slander	difamación
satisfied	satisfecho
appealing	atractivo
atrocities	atrocidades
battered	maltratadas
renewed	renovado
damper	apagador
vent	respiradero
diplomatic	diplomático
eminence	eminencia
twist	torcedura
omission	omisión
sumptuously	suntuosamente
flawed	defectuoso
uncompromising	intransigente
scratch	rasguño
refute	refutar
strained	tenso
bombastic	rimbombante
rotten	podrido
stark	rígido
successes	éxitos
unimaginable	inimaginable
squealing	chillido
rivalry	rivalidad
sporadic	esporádico
scornfully	desdeñosamente
interests	intereses
sensible	sensato
infallibly	infaliblemente
defamations	difamaciones
proactive	proactivo
pleasingly	agradablemente
attractive	atractivo
obscures	oscurece
scarred	cicatrizado
demoralizing	desmoralizador
rejoice	alegrarse
expel	expulsar
iniquitous	inicuo
wealthy	rico
petrify	petrificar
impolite	descortés
inconveniently	inconvenientemente
bloated	hinchado
blameworthy	censurable
junk	basura
tempt	tentar
vengefully	vengativamente
hegemony	hegemonía
calamitously	horriblemente
right	derecho
disdainful	desdeñoso
coherent	coherente
inflame	inflamar
impatience	impaciencia
stunningly	sensacionalmente
unjust	injusto
belittling	menosprecio
youthful	juvenil
subvert	subvertir
negatives	negativos
revitalize	revitalizar
amity	amistad
endorses	respalda
apathetic	apático
susceptible	probablemente
allergy	alergia
traumatic	traumático
dubiously	dudosamente
dazed	aturdido
generous	generoso
impossibly	imposiblemente
aspersions	aspersiones
anti-israeli	anti-israelí
delightful	encantador
immense	inmenso
golden	dorado
vindictive	vengativo
defeats	derrotas
startle	asustar
loophole	escapatoria
pandering	proxenetismo
tremendously	tremendamente
urgent	urgente
talent	talento
greasy	grasiento
dawn	amanecer
unaffordable	inasequible
curses	maldiciones
upliftment	inspiración
inanely	estúpidamente
mighty	poderoso
audaciousness	audacia
totalitarian	totalitario
thank	agradecer
disrespectfully	irrespetuosamente
courageously	valientemente
brilliantly	brillantemente
guilty	culpable
ill-advised	desaconsejado
prisoner	prisionero
skeptically	escepticismo
lucky	afortunado
unfriendly	hostil
stodgy	pesado
conspicuous	conspicuo
chunky	fornido
denying	negando
lawbreaker	transgresor
unreachable	inalcanzable
bearish	bajista
friggin	puto
majesty	majestad
deter	disuadir
decrepit	decrépito
tyrant	tirano
stern	popa
naughty	travieso
excellent	excelente
scandalously	escandalosamente
rot	podredumbre
flagrantly	notoriamente
expansive	expansivo
favorited	favorito
disproportionate	desproporcionado
anti-social	antisocial
clever	inteligente
hassle	molestia
respectable	respetable
misgivings	recelos
interferes	interfiere
downgrade	degradar
passionately	apasionadamente
frustrating	frustrante
reprimand	reprimenda
unuseable	inutilizable
grainy	granoso
break-ups	rupturas
sorrow	dolor
tin-y	estaño-y
wieldy	manejable
unrelentingly	implacablemente
shroud	mortaja
soapy	jabonoso
shimmering	reluciente
tranquility	tranquilidad
marvellous	maravilloso
cliche	cliché
impudence	impudencia
inexperienced	despistados
recession	recesión
fondly	afectuosamente
humour	humor
unforeseen	contingencias
stooge	secuaz
maniac	maníaco
unsteadiness	inestabilidad
poisonous	nocivo
outwit	burlar
lackadaisical	lánguido
irrelevance	irrelevancia
mania	manía
doom	perdición
despicably	vilmente
arbitrary	arbitrario
proficient	competente
pleasing	agradable
offensive	ofensiva
glad	contento
gullible	crédulo
detrimental	perjudicial
shocked	conmocionado
evaluative	evaluativo
streaky	entreverado
speedily	rápidamente
doubts	dudas
invidious	injusto
afflict	afligir
mysteriously	misteriosamente
snobbish	snob
triumphantly	triunfantemente
downside	desventaja
reclaim	reclamar
menial	servil
pander	alcahuete
measly	miserable
chagrin	disgusto
freezing	congelación
severe	grave
unraveled	desentrañado
effusiveness	efusividad
damn	maldito
stains	manchas
blasphemy	blasfemia
stuttering	tartamudeo
strangely	extrañamente
creak	crujido
foolishness	necedad
blasted	maldito
hardship	privación
inconsiderately	desconsideradamente
wisdom	sabiduría
zapped	zapping
distinction	distinción
loses	pierde
wrinkle	arruga
resentment	resentimiento
humility	humildad
misunderstood	malinterpretado
avariciously	avariciosamente
oblique	oblicuo
aghast	espantado
meanness	mezquindad
wrath	ira
misses	pierde
burned	quemado
sticky	pegajoso
irrationals	irracionales
commend	encomendar
rue	ruda
flair	instinto
randomly	azar
bleed	sangrar
trivially	trivialmente
aspiration	aspiración
lacking	carente
vomited	vomitado
2-faces	2-caras
fake	falso
maddening	enloquecedor
sidetracked	desviarse
ignorant	ignorante
accessable	accesible
humiliation	humillación
intrusion	intrusión
adventuresome	aventurero
stiffness	rigidez
complacent	complaciente
arrogant	arrogante
inexpert	inexperto
faint	débil
vouch	atestiguar
troublesome	molesto
standout	destacado
instable	inestable
trash	basura
conceit	presunción
hallucination	alucinación
bullshit	mierda
crashes	accidentes
huckster	mercachifle
eagerness	afán
disloyal	desleal
complain	quejarse
argumentative	discutidor
ergonomical	ergonómico
smack	golpe
easing	aliviando
upset	trastorno
aborted	abortado
thorny	espinoso
traduce	difamar
oddly	extrañamente
excel	sobresalir
prick	pinchazo
blurry	borrosa
disturbingly	perturbadoramente
steal	robar
dripping	goteo
exterminate	exterminar
pessimism	pesimismo
agonizingly	agonizantemente
inconsistent	inconsistente
fatalistically	fatalistamente
sneer	burla
rejuvenated	rejuvenecido
reassure	tranquilizar
unnerved	enervado
discredit	desacreditar
lavish	pródigo
gangster	gángster
glut	superabundancia
ambitiously	ambiciosamente
squash	calabacín
counter-productive	contraproducente
importunate	importuno
illuminating	iluminador
grating	rejilla
blandish	ablandar
soundness	solvencia
reverently	reverentemente
incautious	incauto
enhances	mejora
commendably	encomiable
inactive	inactivo
bonus	prima
enraging	enfurecedora
derisively	burlonamente
resurgent	resurgente
bungling	torpeza
dignified	digno
difficulties	dificultades
dissembler	disimulador
undermined	minado
grievous	grave
incapable	incapaz
disastrous	desastroso
spoil	estropear
emergency	emergencia
glory	gloria
instructive	instructivo
cheap	barato
adjustable	ajustable
melodramatic	melodramático
baffle	deflector
squeaky	chirriante
disquietingly	inquietante
jealous	celoso
whooa	hala
sadden	entristecer
elevate	elevar
exploitation	explotación
infest	infestar
whining	gimoteo
terrifically	estupendamente
cherished	querido
eye-catching	llamativo
belie	desmentir
superfluous	superfluo
harrow	grada
negate	negar
desperation	desesperación
ruin	ruina
spectacular	espectacular
distrust	desconfianza
usable	utilizable
compact	compacto
dissatisfies	ordissatisfies
shortness	falta
fatally	fatalmente
prettily	bonitamente
charmingly	encantadoramente
impurity	impureza
deterioration	putrefacción
harangue	arenga
denied	negado
impede	impedir
slashing	roza
mistake	error
optimism	optimismo
denial	negación
exceed	exceder
gifted	dotado
waning	menguante
beauteous	hermoso
disintegrates	desintegra
wobbled	tambaleado
exploit	explotar
scarcity	escasez
tension	tensión
selfish	egoísta
manic	maníaco
illuminate	iluminar
honoring	homenaje
sadness	tristeza
excoriate	excoriar
haughty	altivo
sly	astuto
amiss	mal
bewildering	desconcertante
discomfort	dolor
reverence	reverencia
pillage	saqueo
disintegration	desintegración
serene	sereno
revolting	repugnante
paradoxical	paradójico
mobster	gángster
heartwarming	reconfortante
denunciate	denunciar
gratified	gratificado
courtly	cortés
positive	positivo
integral	exhaustivo
frustration	frustración
conciliatory	conciliador
commiserate	compadecer
noxious	nocivo
debility	debilidad
exhort	exhortar
snub	desaire
endorsing	endosar
waste	residuos
impeach	procesar
ghetto	gueto
infidels	infieles
detraction	detracción
monster	monstruo
reticent	reticente
saintly	santo
scream	grito
entrust	confiar
oppression	opresión
consummate	consumado
realistic	realista
imposing	colonial
torturing	tortura
lovable	amable
boycott	boicoteo
exciting	emocionante
figurehead	testaferro
bleakness	desolación
honesty	honestidad
braggart	fanfarrón
saint	santo
drab	monótono
hum	zumbido
sneak	furtivo
brotherly	fraternal
taut	tirante
healthful	sano
chastisement	castigo
calamitous	calamitoso
tentatively	tentativamente
devastating	devastador
dissidence	manzana
slug	babosa
floored	solado
trapped	atrapado
negative	negativo
phobic	fóbico
indignity	indignidad
despondency	abatimiento
frigid	frígido
brittle	quebradizo
indiscretion	indiscreción
sugar-coat	endulzar
foreboding	presentimiento
prudently	prudentemente
reluctant	reacio
patiently	pacientemente
ferocity	ferocidad
deluded	iluso
mangled	mutilado
superb	magnífico
scorching	abrasador
ripoff	estafa
dissocial	disociable
enticed	atraídos
serenity	serenidad
cackle	cacareo
lame-duck	saliente
caustically	cáusticamente
blissful	feliz
confusions	confusiones
annoy	molestar
insignificance	insignificancia
devious	tortuoso
frightfully	espantosamente
abysmally	abismalmente
wail	gemido
convience	conveniencia
messes	líos
disservice	deservicio
allergic	alérgico
redemption	redención
repress	reprimir
buggy	calesa
thankful	agradecido
underlings	subordinados
enchanting	encantador
squander	tiempo
impotent	impotente
blemish	mancha
expropriate	expropiar
uneasily	inquieto
shimmer	brillo
encouragingly	alentador
berate	regañarse
irritations	irritaciones
recomend	recomiendo
stinks	apesta
bust	busto
unity	unidad
exellent	excelente
runaway	fugitivo
unwillingness	renuencia
snappishly	brusquedad
ruining	arruinando
catastrophically	catastróficamente
limitation	limitación
indecently	indecentemente
uplift	inspirar
unintelligible	ininteligible
handily	cómodamente
ungrateful	ingrato
meticulous	meticuloso
merriment	alegría
erratically	erráticamente
self-respect	dignidad
slowed	ralentizado
betray	traicionar
concern	preocupación
unstable	inestable
conveniently	convenientemente
fruitless	infructuoso
arrogance	arrogancia
fiendish	diabólico
pitiful	lamentable
rectifying	rectificación
exhorbitant	exorbitante
terrific	estupendo
embroilment	embrollo
pitiless	despiadado
melodramatically	melodramáticamente
defective	defectuoso
bankrupt	quebrado
raked	rastrillado
triumphant	triunfal
diligence	diligencia
timid	tímido
mire	fango
blockhead	alcornoque
detracts	detrae
loser	perdedor
drippy	pegajosa
embarrassing	embarazoso
stylized	estilizado
accurately	exacto
inexpensive	barato
tumbled	caído
dashing	gallardo
impulsively	impulsivamente
infamously	infamemente
redeem	redimir
concise	conciso
welcome	bienvenida
pleases	plazca
defunct	difunto
blatantly	descaradamente
danke	gracias
barbarity	barbarie
condemnable	condenable
virulence	virulencia
exacerbate	exacerbar
miraculous	asombroso
dissolution	disolución
productively	productivamente
admiration	admiración
fabrication	fabricación
prejudge	prejuzgar
apologist	apologista
harmless	inofensivo
blurs	desenfoques
inhibit	inhibir
bafflement	desconcierto
nervously	nerviosamente
barbaric	bárbaro
defamation	difamación
destiny	destino
incendiary	incendiario
bemoan	lamentar
readily	fácilmente
authoritative	autorizado
razor-sharp	afilada
glib	elocuente
overtakes	adelanta
poor	pobre
confusion	confusión
doddering	chocho
intimacy	intimidad
altruistically	altruistamente
orphan	huérfano
surpass	superar
indecisively	indeciso
brand-new	flamante
tiresome	cansado
impressively	impresionantemente
grievances	quejas
fresh	fresco
anxieties	ansiedades
impoverish	empobrecer
untimely	inoportuno
disbelief	incredulidad
spewed	vomitado
loud	ruidoso
confrontation	confrontación
brazen	descarado
infallible	infalible
bashing	paliza
depressed	deprimido
dark	oscuro
cruelty	crueldad
fails	falla
recklessness	imprudencia
horrifies	horroriza
twisted	retorcido
repression	repressió
forgetfulness	olvido
smoldering	latente
polluter	contamina
improvement	mejora
panic	pánico
talents	talentos
disagreeable	desagradable
torturous	tortuoso
crush	aglomeración
mortify	mortificar
powerfully	poderosamente
beutifully	hermosamente
stump	muñón
adore	adorar
transparent	transparente
clog	zueco
destitute	indigente
hobble	cojera
unrestricted	irrestricto
electrify	electrizar
affable	afable
hallmark	contraste
greatest	mayor
idiocies	idioteces
sinking	hundimiento
laggy	lag
falsely	falsamente
auspicious	propicio
distinctive	distintivo
petty	mezquino
outrageous	indignante
insurrection	insurrección
swanky	ostentoso
contradict	contador
disconcerting	desconcertante
awe	temor
regard	respecto
fairly	bastante
profoundly	profundamente
busybody	entrometido
lapses	lapsos
comforting	consolador
spank	azotar
puppet	marioneta
undocumented	indocumentado
skill	habilidad
alarm	alarma
outdo	exceder
resistance	resistencia
zest	entusiasmo
disruptive	disruptivo
pertinacity	pertinacia
glowingly	elogiosamente
vain	vano
startlingly	sorprendentemente
pleasurable	placentero
profusion	profusión
corrosion	corrosión
acumen	perspicacia
intermittent	intermitente
tricky	difícil
sharp	afilado
glum	sombrío
moron	idiota
hampered	obstaculizado
satisfactorily	satisfactoriamente
losers	perdedores
felicitate	felicitar
providence	providencia
recommendation	recomendación
goon	matón
despotic	despótico
volatile	volátil
steadfastly	firmemente
contribution	contribución
poorly	mal
phenomenally	fenomenalmente
clogged	obstruido
disquietude	desasosiego
condescend	condescender
crowdedness	hacinamiento
torrent	torrente
whips	látigos
detracted	detraído
lavishly	profusamente
rightness	justicia
abnormal	anormal
impossible	imposible
craftly	artesanalmente
ethical	ético
dreadful	terrible
congratulatory	congratulatorio
arduous	arduo
despair	desesperación
thoughtfulness	consideración
emptiness	vacío
damnable	detestable
courageousness	valentía
unjustly	injustamente
catastrophies	catástrofes
prodigy	prodigio
robust	robusto
shamefully	vergonzosamente
sweet	dulce
idiotic	idiota
growl	gruñido
panoramic	panorámico
tainted	contaminado
despise	despreciar
acerbic	acerbo
smitten	prendado
slanders	calumnias
award	premio
smoke	humo
overstatements	exageraciones
errors	errores
loose	suelto
persecute	perseguir
incorrectly	incorrectamente
burn	quemar
disadvantaged	perjudicado
absent-minded	distraído
languorous	lánguido
weakness	debilidad
defiant	desafiante
stutters	tartamudea
plight	situación
stranger	desconocido
cry	grito
menacing	amenazador
calming	calmante
declines	descensos
overrated	sobrevalorado
afflictive	doloroso
taunts	burlas
erosion	erosión
slanderous	calumnioso
richly	ricamente
prejudice	prejuicio
indebted	endeudado
complained	quejado
demonic	demoníaco
dextrous	diestro
displaced	desplazado
vomits	vómitos
infuriated	enfurecido
breakup	ruptura
challenging	desafiante
accuses	acusa
impermissible	inadmisible
ecstatic	extático
scathingly	mordazmente
gratitude	agradecimiento
seriousness	seriedad
bungle	chapucear
ranted	despotricó
embarrass	avergonzar
crafty	astuto
unprepared	desprevenido
contortions	contorsiones
madden	enloquecer
skittish	asustadizo
gem	joya
dehumanize	deshumanizar
sufficient	suficiente
holy	santo
abuse	abuso
finicky	melindroso
licentious	licencioso
craven	cobarde
recoil	retroceso
penalize	penalizar
vexingly	irritantemente
feeble	débil
back-woods	back-maderas
correctly	correctamente
corrosions	corrosiones
impeccably	impecablemente
superstitious	supersticioso
fractious	díscolo
stringent	riguroso
obstruction	obstrucción
cohesive	cohesivo
regally	regiamente
partisans	partidarios
insinuation	insinuación
stab	puñalada
snazzy	elegante
bliss	felicidad
infuriating	exasperante
poetic	poético
fortunate	afortunado
concede	conceder
consistently	consecuentemente
pertinaciously	pertinazmente
wretched	miserable
alluring	seductor
shaky	tambaleante
blatant	descarado
faze	perturbar
nimble	ágil
lose	perder
dependable	confiable
overturn	volcar
betraying	traicionero
exalt	exaltar
sabotage	sabotaje
reliably	fiable
bloom	floración
implicate	implicar
danger	peligro
disquieting	inquietante
discordance	discordancia
audacious	audaz
flawless	perfecto
haste	prisa
scratched	rayado
loathe	detestar
smudge	mancha
uncivilized	incivilizado
expeditiously	expedita
tranquil	tranquilo
brisk	enérgico
calmness	calma
stupidity	estupidez
hypocricy	hipocresía
lag	retraso
integrated	integrado
gross	bruto
hegemonistic	hegemonística
enviably	envidiablemente
troubled	turbulento
crazily	locamente
fool	engañar
impartial	imparcial
revival	renacimiento
stupor	estupor
misleadingly	engañosamente
recommendations	recomendaciones
gruesomely	horriblemente
petrified	petrificado
pure	puro
inappropriately	inapropiadamente
apocalyptic	apocalíptica
monstrosities	monstruosidades
beneficially	beneficiosamente
leading	líder
intrigue	intriga
disgraceful	vergonzoso
scandalize	escandalizar
protest	protesta
distrustful	desconfiado
ricer	arrocera
grind	moler
overloaded	sobrecargado
glaringly	deslumbrante
cherub	querubín
crazy	loco
counterproductive	contraproducente
revile	injuriar
frost	helada
stale	viciado
sick	enfermo
inescapable	inevitable
pretentious	pretencioso
ridicule	ridículo
stain	mancha
lie	mentira
burning	ardiente
astonished	sorprendido
contempt	desprecio
appreciated	apreciado
contemptible	despreciable
mope	melancólico
tyrannically	tiránicamente
boiling	ebullición
pique	piqué
archaic	arcaico
hamper	estorbar
pluses	ventajas
unhealthy	insalubre
satisfying	satisfactorio
unsuccessful	infructuoso
disrupt	interrumpir
pigs	cerdos
invader	invasor
gaudy	llamativo
inconsiderate	desconsiderado
irritate	irritación
lukewarm	tibio
glistening	brillante
stammer	balbuceo
fickle	voluble
invigorate	vigorizar
imperiously	imperiosamente
playful	juguetón
suffices	suficiente
picketed	piquetes
baffling	desconcertante
handicapped	discapacitados
pollute	contaminar
faults	fallas
revoke	revocar
simplified	simplificado
monotonous	monótono
excelled	sobresalido
rectification	rectificación
agreeable	agradable
inaction	inacción
busts	bustos
hooray	hurra
reprehensibly	censurablemente
onslaught	embate
shrouded	envuelto
rebellious	rebelde
temptation	tentación
insufferable	insufrible
irritated	irritado
overbearing	imperioso
sink	fregadero
lonely	solitario
demonize	demonizar
amputate	amputar
oversimplification	sobresimplificación
alarmingly	alarmantemente
tenuous	tenue
scorn	desdén
indistinguishable	indistinguible
interruptions	interrupciones
undercuts	socavados
partisan	partidario
bitterness	amargura
reluctance	renuencia
prestige	prestigio
indeterminate	indeterminado
absentee	ausente
toxic	tóxico
daze	aturdimiento
hysteric	histérico
steals	robos
blockage	obstrucción
confident	confiado
sincere	sincero
ruins	ruinas
admonish	amonestar
discouragement	desaliento
adaptive	adaptado
drawbacks	inconvenientes
unnerve	enervar
smooth	liso
missed	perdido
generously	generosamente
disasterous	desastroso
elate	regocijado
irrational	irracional
sorrowful	triste
inconsequential	inconsecuente
problem	problema
smilingly	sonriendo
watered-down	aguada
prickle	espina
bullies	matones
nemesis	justicia
disinterested	desinteresado
emphatically	enfáticamente
downsides	desventajas
optimal	óptima
criticizing	criticar
harass	acosar
antagonize	contrariar
jubilation	jubilación
stable	estable
belligerent	beligerante
successful	exitoso
stumbled	tropezado
dying	moribundo
ironical	irónico
proves	prueba
capriciously	caprichosamente
dirts	suciedades
reprehensive	reprensibles
seasoned	sazonado
obliterate	obliterar
inexperience	inexperiencia
bowdlerize	expurgar
eloquence	elocuencia
pretty	bastante
stagnation	estancamiento
straighten	directamente
bunk	litera
explode	explotar
ludicrously	ridículamente
setback	revés
extortion	extorsión
fun	diversión
direly	imperiosamente
traitor	traidor
provoke	provocar
hothouse	invernáculo
drastically	drásticamente
painfully	penosamente
heathen	pagano
taint	mancha
gritty	arenoso
contaminated	contaminado
crept	deslizado
evade	evadir
jollify	alegrar
injure	lesionar
panicking	pánico
champion	campeón
gracious	gracioso
stereotype	estereotipo
quash	anular
self-defeating	contraproducente
dogged	obstinado
sensations	sensaciones
happily	felizmente
discompose	descomponer
authoritarian	autoritario
insubstantially	insustancial
misbegotten	bastardo
indifferent	indifférent
clearly	claramente
decent	bueno
inconsolably	inconsolablemente
villains	villanos
crumpled	arrugado
scathing	mordaz
noisy	ruidoso
shrivel	encoger
unhappiness	infelicidad
shirker	gandul
conspiracy	conspiración
reasonably	razonablemente
venerate	venerar
nettle	ortiga
amicable	amistoso
hissed	siseado
restrict	restringir
delude	engañarse
opinionated	dogmático
unachievable	inalcanzable
implode	implosionar
avid	ávido
navigable	navegable
paramount	importantísimo
depressions	depresiones
impure	impuro
overheat	sobrecalentar
viciously	viciosamente
perverse	perverso
itching	prurito
frustrate	frustrar
tingle	hormigueo
ingratitude	ingratitud
leads	plomos
adversarial	contradictorio
affordably	asequible
choppy	picado
cannibal	caníbal
eye-catch	ojo-captura
incompatability	incompatibilidad
jaded	hastiado
bulky	voluminoso
immorally	inmoralmente
overstates	exagera
venomous	venenoso
unbearable	inaguantable
clumsy	torpe
mislead	engañar
sleek	pulcro
explosive	explosivo
uncaring	indiferente
unlawfully	ilegalmente
helped	ayudado
promising	propicio
havoc	estragos
loss	pérdida
endorsed	endosado
faultless	impecable
infallibility	infalibilidad
outdone	aventajado
hale	sano
stunted	enano
unavoidably	inevitablemente
contemptuously	desdeñosamente
brilliant	brillante
bravado	bravata
interrupt	interrumpir
eagerly	ansiosamente
beneficiary	beneficiario
repugnant	repugnante
truthfulness	veracidad
scare	susto
lascivious	lascivo
approval	aprobación
finer	finlandés
scornful	desdeñoso
profound	profundo
notably	notablemente
ambush	emboscada
remarkable	notable
parody	parodia
mourn	llorar
tiring	fatigoso
debatable	discutible
fumes	humo
jeopardy	peligro
unreal	irreal
upbeat	optimista
enhancement	realce
reconciliation	reconciliación
amazement	asombro
diametrically	diametralmente
wayward	rebelde
rejuvenate	rejuvenecer
accuse	acusar
prowess	proeza
miscellaneous	diverso
illogical	ilógico
disillusioned	desilusionado
travesty	parodia
diabolically	diabólicamente
fascist	fascista
lucidly	lúcidamente
drawback	inconveniente
paralize	paralizar
annoyances	molestias
indiscreet	indiscreto
defiantly	desafiante
nastily	groseramente
impetuously	impetuosamente
hypocrite	hipócrita
crash	choque
recessionary	recesivo
bleakly	desoladamente
ominously	ominosamente
rogue	pícaro
unfaithfully	infielmente
gentle	suave
concerns	preocupaciones
shit	mierda
facilitate	facilitar
peaceful	pacífico
trivialize	trivializar
nourishment	alimento
cramping	calambres
stereotypically	típico
barbarically	bárbaramente
brutality	brutalidad
doubtful	dudoso
inflict	infligir
immoderately	inmoderadamente
sexy	atractivo
distasteful	desagradable
breach	incumplimiento
blabber	chismoso
poise	porte
mawkish	empalagoso
best	mejor
sarcastic	sarcástico
envy	envidia
uncollectible	incobrables
chivalrous	caballeroso
hasty	apresurado
break	pausa
obscurity	oscuridad
saver	ahorrador
satisfy	satisfacer
crooks	ladrones
exultant	jubiloso
plebeian	plebeyo
hoodwink	engañar
faithful	fiel
wedge	cuña
insurmountable	insuperable
enthuse	entusiasmar
neatly	pulcramente
sloth	pereza
eruptions	erupciones
unequivocally	inequívocamente
messing	ensuciando
regret	lamentar
scramble	lucha
ragged	harapiento
proud	orgulloso
retreated	retirado
luminous	luminoso
unsound	defectuoso
acrimony	acritud
barbarian	bárbaro
jeers	burlas
ferociously	ferozmente
undisputably	indiscutiblemente
obscure	oscuro
sad	triste
tanks	tanques
whine	silbido
viewable	visible
loathsome	repugnante
predatory	depredador
incorrect	incorrecto
besiege	sitiar
plusses	pros
oddity	rareza
fibber	mentiroso
pricey	caro
devoid	vacío
massacres	masacres
insolently	insolentemente
congestion	congestión
advantage	ventaja
clunky	torpe
aggrieved	agraviado
lawlessness	desorden
primitive	primitivo
likable	agradable
effectiveness	efectividad
pretence	pretensión
tentative	tentativo
procrastination	dilación
berserk	enloquecido
perseverance	perseverancia
captivate	cautivar
sucker	ventosa
comfy	confortable
dislike	aversión
outsider	forastero
accolades	reconocimientos
vengeance	venganza
cancer	cáncer
hideous	horrible
patience	paciencia
heal	sanar
extinguish	destruir
fume	humo
incomprehensible	incomprensible
ashamed	avergonzado
defects	defectos
distort	distorsionar
problematic	problemas
fans	ventiladores
officious	oficioso
irksomeness	fastidio
congratulations	felicitaciones
grace	gracia
cumbersome	incómodo
heck	infierno
beggarly	miserable
dispute	disputa
graciously	graciosamente
absurdly	absurdamente
articulate	articular
frozen	congelado
shriek	chillido
dungeons	mazmorras
fatuity	fatuidad
amusingly	graciosamente
contaminating	contaminar
ill-natured	malévolo
dragging	arrastrando
keenness	agudeza
degenerate	degenerado
drags	arrastra
foolhardy	temerario
spookier	fantasmagóricos
dishonor	deshonor
charitable	caritativo
shamelessly	desvergonzadamente
subjugate	subyugar
nicest	mejor
somber	sombrío
resilient	resistente
restored	restaurada
offensiveness	ofensivo
dissatisfy	descontentar
rightful	legítimo
guarantee	garantía
subpoenas	citaciones
fall	caer
intimate	íntimo
overbalanced	sobrenivelado
gaily	alegremente
crisper	rizador
beautify	embellecer
diatribe	diatriba
equivocal	equívoco
acclaim	aclamación
licentiousness	libertinaje
glitz	brillo
scandal	escándalo
sketchy	incompleto
fortuitously	fortuitamente
lawful	legal
devil	diablo
refusal	negativa
fatuously	fatuamente
villainously	vilmente
contort	retorcer
enflame	inflamar
tangles	ovillos
dope	droga
dazzle	deslumbrar
kindness	bondad
heretical	herético
arrogantly	arrogantemente
outburst	explosión
fanaticism	fanatismo
feign	fingir
hateful	odioso
creeps	grima
catastrophic	catastrófico
cooperative	cooperativa
entangle	enredar
obese	obeso
piety	piedad
rapt	absorto
infested	infestada
offensively	ofensivamente
quitter	cobarde
burden	carga
sagacity	sagacidad
damaged	estropeado
unwarranted	injustificado
break-up	ruptura
fascism	fascismo
banish	desterrar
titillating	excitante
fried	frito
eviscerate	destripar
felon	delincuente
insignificantly	insignificantemente
drunken	borracho
imbecile	imbécil
mists	nieblas
helpful	útil
dearth	escasez
deft	hábil
obsessively	obsesivamente
touts	revendedores
fault	culpa
precipitous	escarpado
disappoint	decepcionar
strikingly	sorprendentemente
unproductive	improductivo
demeaning	degradante
scummy	espumoso
striving	esfuerzos
evildoer	malhechor
succes	éxito
blackmail	chantaje
appreciate	apreciar
slaughter	masacre
haughtily	altivamente
rusty	oxidado
devilishly	diabólicamente
impending	inminente
instigate	instigar
wane	menguar
neurotic	neurótico
reproach	reproche
powerless	impotente
shipwreck	naufragio
warmly	calurosamente
uglier	feo
properly	correctamente
diligently	diligentemente
over-hyped	exageradas
indolent	indolente
apprehension	aprensión
wrangle	reñir
infraction	infracción
dilapidated	arruinado
enliven	animar
defy	desafiar
catchy	pegadizo
outrage	atropello
naively	ingenuamente
ingeniously	ingeniosamente
murderous	asesino
truant	ausente
cheerless	triste
virtue	bushido
competitive	competitivo
conscientious	concienzudo
smudged	manchado
exhilaration	regocijo
frustratingly	frustrante
fruitful	fructífero
unlimited	ilimitado
delinquency	delincuencia
rough	áspero
decadence	decadencia
bored	perforado
overwhelming	aplastante
rapport	compenetración
sprightly	animado
fulfillment	cumplimiento
famed	famoso
embroil	embrollar
vehement	vehemente
condescending	condescendiente
magic	magia
squabbling	disputas
survivor	sobreviviente
uneasy	inquieto
ominous	siniestro
accommodative	acomodaticia
morbid	mórbido
cancerous	canceroso
grandeur	grandeza
sucks	chupa
prohibit	prohibir
irresponsible	impulsivo
zippy	enérgico
ecstasy	éxtasis
laid-off	despedidos
heroine	heroína
escapade	escapada
positives	positivos
odd	impar
inequitably	inequitativamente
knave	sota
swindle	estafa
praising	alabando
quibble	sutileza
haters	enemigos
erroneously	erróneamente
chastise	castigar
egocentric	egocéntrico
skinny	flaco
attack	ataque
wrestle	luchar
elation	elación
squirm	retorcerse
distressed	angustiado
assault	asalto
snappish	brusco
jaw-droping	asombroso
chatterbox	charlatán
hysterically	histéricamente
worth	valor
inconsequently	inconsecuentemente
wheedle	engatusar
irresolvable	irresoluble
distinguished	distinguido
thrill	emoción
absurd	absurdo
paucity	escasez
intrude	entrometerse
crumbling	desmoronamiento
radicalization	radicalización
dubious	dudoso
improperly	indebidamente
martyrdom	martirio
misgiving	recelo
mocking	burlón
graceful	agraciado
harden	duro
lull	calma
tattered	andrajoso
adulation	adulación
heavenly	celestial
outshine	eclipsar
diversified	diversificado
egotism	egotismo
geezer	vejestorio
impoverished	empobrecido
hefty	fuerte
sedentary	sedentario
miss	señorita
sufficed	bastado
spooky	fantasmal
good	bueno
capable	capaz
smelling	oliendo
assurances	garantías
critic	crítico
disaster	desastre
woebegone	desconsolado
hilarious	hilarante
prattle	parloteo
imprecise	impreciso
divine	divino
washed-out	desteñido
excites	excita
precise	preciso
dehumanization	deshumanización
immaculately	inmaculadamente
mournfully	tristemente
tragic	trágico
incitement	incitación
jam	mermelada
tantrum	berrinche
verifiable	verificable
anarchism	anarquismo
ail	afligir
indoctrinate	adoctrinar
outperforms	supera
subversively	subversivamente
disabled	discapacitado
guiltily	culpablemente
domineering	dominador
hooligan	gamberro
hassles	molestias
livid	lívido
diatribes	diatribas
dissappointing	decepcionante
laughingstock	hazmerreír
strenuous	agotador
anomalous	anómalo
despot	déspota
lame	cojo
unsettle	trastornar
suffer	sufrir
famine	hambre
loathing	aborrecimiento
reputable	acreditado
excruciating	agudísimo
eulogize	elogiar
enthralled	cautivados
goodness	bondad
imprison	aprisionar
simplistically	simplista
adventurous	aventurero
disconcerted	desconcertado
exorbitant	exorbitante
back-wood	back-madera
reformed	reformado
appreciable	apreciable
deceiver	engañador
time-honored	tradicional
bitch	perra
bewilder	confundir
stolen	robado
gloom	penumbra
contrasty	contrastada
disquiet	desasosiego
restructured	reestructurado
cunts	coños
recommended	recomendado
anti-semites	antisemitas
pep	brillo
stupendously	estupendamente
languid	lánguido
paralyzed	paralizado
demon	demonio
indecorum	indecoro
disparagingly	despectivamente
haze	neblina
adulate	adular
dissonant	disonante
protested	protestado
disapproving	desaprobación
self-interested	egoísta
staunchly	incondicionalmente
ill-fated	malogrado
declaim	declamar
egomania	egomanía
deny	negar
viper	víbora
smudges	manchas
snag	pega
morbidly	mórbida
righten	derecho
enthral	cautivar
rupture	ruptura
dispiritedly	desánimo
appreciates	aprecia
infringe	infringir
enterprising	emprendedor
gladness	alegría
false	falso
failures	fracasos
bleeding	sangrado
merit	mérito
implausibly	inverosímilmente
persecution	persecución
spew	arrojar
winner	ganador
displeasing	desagradable
nourish	nutrir
admonisher	amonestador
striking	llamativo
thriving	próspera
overtake	adelantar
errant	errante
grief	dolor
polarisation	polarización
cheating	trampa
reaffirmation	reafirmación
secretive	reservado
sustainable	sostenible
sanctimonious	mojigato
frightening	aterrador
lethargic	letárgico
awards	premios
felicity	dicha
indecisive	indeciso
vexing	irritante
rude	grosero
dauntingly	intimidantemente
bothered	molestado
dupe	incauto
injustices	injusticia
provocative	provocativo
wallow	revolcarse
futilely	inútilmente
despondently	desaliento
sinister	siniestro
stubborn	obstinado
wreaked	causado
adverse	adverso
desiring	desear
dishonorable	deshonroso
dynamic	dinámico
madman	loco
joyous	jubiloso
insane	demente
disinclination	aversión
thinner	disolvente
embroiled	embrollado
stigma	estigma
marvelous	maravilloso
momentous	trascendental
kindly	amablemente
upheaval	convulsión
rife	abundante
responsibly	responsable
boggle	sobresaltarse
ruinous	ruinoso
deficient	deficiente
enchant	encantar
rejoicing	alegría
harmoniously	armoniosamente
sensitive	sensible
vehemently	vehementemente
expensive	caro
inaptitude	ineptitud
pointlessly	inútilmente
flairs	ensanchamientos
affordable	asequible
nonexistent	inexistente
blow	golpe
gutsy	valiente
confrontational	confrontación
advocated	propugnado
lucrative	lucrativo
affluent	afluente
novelty	novedad
tramp	vagabundo
deceptive	engañoso
dreary	triste
improve	mejorar
relapse	recaída
mendacious	mendaz
bruises	contusiones
gainsay	contradecir
skeletons	esqueletos
ennoble	ennoblecer
afford	permitirse
remorsefully	remordimiento
inaccurate	inexacto
overblown	marchito
awful	horrible
recover	recuperar
tanked	tanqueado
tormented	atormentado
freakish	anormal
disclaim	renunciar
hegemonism	hegemonismo
ineffectually	ineficazmente
unfairly	injustamente
persevere	perseverar
outcry	grito
struggles	luchas
upgradable	actualizable
self-serving	auto-servicio
meltdown	crisis
broken	roto
overplay	exagerar
savings	ahorros
stormy	tempestuoso
mystery	misterio
wary	cauteloso
nicely	bien
throbbing	palpitante
honored	honrado
worry	preocuparse
sufferer	víctima
limitations	limitaciones
disprove	refutar
obscene	obsceno
punitive	punitivo
shirk	eludir
boost	impulsar
sarcasm	sarcasmo
unfazed	imperturbable
leakage	fuga
virtuous	virtuoso
insufficiency	insuficiencia
bullying	intimidación
phony	falso
spendy	caro
mightily	poderosamente
affectation	afectación
drained	agotado
legendary	legendario
dislikes	disgustos
mist	niebla
ignoble	innoble
picket	piquete
undermines	socava
screech	chillido
burdensome	gravoso
bomb	bomba
unwieldy	pesado
infidel	infiel
impair	perjudicar
disoriented	desorientado
unsupportive	insolidario
nauseates	náuseas
incite	incitar
nasty	repugnante
savage	salvaje
disinterest	desinterés
indefensible	indefendible
hesitant	vacilante
pokey	diminuto
egregiously	notoriamente
crumple	arrugarse
continuity	continuidad
hostage	rehén
invasive	invasor
gimmicky	efectista
jaundiced	ictérico
despoil	despojar
flexibility	flexibilidad
paradise	paraíso
corrupts	corrompe
belabor	apalear
clean	limpio
scars	cicatrices
sinisterly	siniestramente
crude	crudo
assassinate	asesinar
notoriously	notoriamente
advocate	defensor
freaking	maldita
slanderer	calumniador
mad	loco
wonderful	maravilloso
lapse	lapso
spilling	derramando
hysterics	histerismo
sorrowfully	tristemente
amazing	asombroso
injurious	perjudicial
straggler	rezagado
freedom	libertad
recant	retractar
indigent	indigente
hack	corte
prickles	espinas
counter-attack	contraataque
blindingly	cegador
condescendingly	condescendientemente
inability	incapacidad
inept	inepto
delusion	ilusión
graft	injerto
cataclysm	cataclismo
righteous	justo
prolific	prolífico
debasement	humillación
trick	truco
debt	deuda
deviousness	desviación
ploy	táctica
jerk	tirón
prison	prisión
indulge	complacer
unjustifiably	injustificadamente
stagnant	estancado
touted	promocionado
demonizing	demonización
contradictory	contradictorio
ridiculously	ridículamente
mesmerizes	hipnotiza
solicitude	solicitud
disappointing	decepcionante
hazardous	peligroso
eyecatching	llamativo
autonomous	autónomo
refinement	refinamiento
prevaricate	prevaricar
rejected	rechazado
flaky	escamoso
preferable	preferible
criticisms	críticas
gems	gemas
poverty	pobreza
prompt	rápido
intriguingly	curiosamente
damnation	condenación
sacrificed	sacrificado
colorful	colorido
rapid	rápido
disappointingly	decepcionantemente
exultation	exultación
bemused	confundido
adversity	adversidad
topple	derribar
comprehensive	exhaustivo
wrinkles	arrugas
outperform	superan
fervently	fervorosamente
economical	económico
brainless	estúpido
maliciously	maliciosamente
quarrelsome	pendenciero
radiance	resplandor
refunded	reintegrado
monumentally	monumentalmente
matchless	incomparable
fluent	fluido
downturns	recesiones
wild	salvaje
incomplete	incompleto
delicious	delicioso
chaff	paja
stately	majestuoso
stagnate	estancarse
excitingly	emocionante
glowing	brillante
affably	afablemente
shiny	brillante
disgustedly	disgusto
apprehensions	aprehensiones
victory	victoria
dwindling	menguante
anti-american	antiamericano
entanglement	enredo
retractable	retráctil
timidly	timidez
undue	indebido
contaminates	contaminantes
fuzzy	borroso
overreach	extralimitarse
virulently	virulentamente
ruined	arruinado
admirer	admirador
perfectly	perfectamente
resentful	resentido
affability	afabilidad
scowl	ceño
lanky	larguirucho
grand	magnífico
ultimatums	ultimátums
heroic	heroico
brusque	brusco
oppositions	oposiciones
taunting	burlas
partiality	parcialidad
neglect	neglecta
accost	abordar
strike	huelga
refine	refinar
grapple	luchar
ingenious	ingenioso
barbarously	bárbaramente
exclusion	exclusión
grim	severo
bait	cebo
superstition	superstición
enhance	mejorar
condescension	condescendencia
luck	suerte
upsets	trastornos
equitable	equitativo
ovation	ovación
inconsistencies	inconsistencias
hallmarks	características
affluence	opulencia
laudable	loable
enemies	enemigos
extremist	extremista
over-acted	sobre-actuado
invaluable	inestimable
reasoned	razonada
warm	caliente
delightfully	deliciosamente
tired	cansado
insouciance	despreocupación
profuse	liberal
hardened	curtido
enemy	enemigo
chatter	charla
attune	adaptar
weariness	cansancio
warned	prevenido
incompetence	incompetencia
trample	pisotear
reachable	alcanzable
racist	racista
threats	amenazas
convenient	conveniente
breakdown	desglose
squeals	chillidos
intransigent	intransigente
injury	lesión
abrupt	abrupto
buoyant	boyante
brutalising	embrutecedor
extravagant	extravagante
torturously	tortuosamente
steeply	abruptamente
complimentary	cortesía
numb	entumecido
commotion	conmoción
vile	vil
rants	rantes
vibrant	vibrante
orderly	ordenado
compulsive	compulsivo
eases	facilita
loopholes	lagunas
pitiable	lamentable
unusual	raro
genuine	genuino
hinder	dificultar
lewdly	lascivamente
morons	tarados
hypocritically	hipócritamente
jerky	espasmódico
desert	desierto
imperfect	imperfecto
outshone	eclipsó
judicious	juicioso
agility	agilidad
intense	intenso
brainy	inteligente
weirdly	extrañamente
panicked	pánico
fist	puño
atrocious	atroz
originality	originalidad
fast	rápido
anarchistic	anarquista
gain	ganancia
frail	frágil
dismay	consternación
kudos	prestigio
detests	detesta
dishonestly	deshonestamente
vivacious	vivaz
woeful	lamentable
amenable	dócil
masterfully	magistralmente
vileness	vileza
brimstone	azufre
bland	soso
scuff	arrastrar
palatial	palaciego
idle	ocioso
joyful	alegre
knowledgeable	experto
inflammed	inflamado
modesty	modestia
adequate	adecuado
apologists	apologistas
chill	frío
suicide	suicidio
wickedly	perversamente
disvalue	disvalor
trusting	confianza
pointless	inútil
unsteady	inestable
genocide	genocidio
disaffect	desafectar
sumptuousness	suntuosidad
courteous	cortés
arcane	arcano
flaw	falla
abused	abusado
monstrosity	monstruosidad
perish	perecer
stridently	estridentemente
uproot	desarraigar
chasten	castigar
credible	creíble
cheery	alegre
simplifies	simplifica
horrifying	horripilante
excessive	excesivo
luxuriant	exuberante
gained	ganado
valiantly	valientemente
strut	puntal
foolishly	neciamente
revengefully	vengativamente
dissatisfied	insatisfecho
nice	agradable
miff	disgustar
shambles	ruinas
carelessness	descuido
disastrously	desastrosamente
disturbed	perturbado
lyrical	lírico
fraught	tenso
franticly	frenéticamente
fulminate	fulminar
gruesome	horrible
displeasure	desagrado
misrepresent	falsificar
disfavor	desfavorecer
dishearteningly	descorazonadoramente
pre-eminent	preeminente
wiles	engaños
drought	sequía
genius	genio
atrophy	atrofia
lament	lamento
dignity	dignidad
thoughtless	irreflexivo
win	victoria
evasive	evasivo
accomplishment	logro
obstructing	obstructivo
moan	gemido
stupendous	estupendo
spinster	solterona
fears	temores
uncertain	incierto
disgrace	desgracia
divinely	divinamente
itch	prurito
irrecoverable	irrecuperable
disagreeably	desagradablemente
recommend	recomendar
fatigued	fatigado
quarrels	peleas
lechery	lascivia
tidy	ordenado
lied	mentido
benefit	beneficio
irritating	irritante
foully	asquerosamente
delinquent	delincuente
immodest	inmodesto
heartily	sinceramente
irrationally	irracionalmente
improper	impropio
enthusiast	entusiasta
encourage	fomentar
sour	agrio
everlasting	eterno
bloodthirsty	sanguinario
hotheaded	exaltado
annihilate	aniquilar
butchery	carnicería
brutally	brutalmente
spews	arroga
motley	abigarrado
oversight	vigilancia
deception	engaño
swagger	contoneo
calumnious	calumniosa
disintegrated	desintegrado
annoyed	irritado
boil	hervir
dishearten	descorazonar
wows	sorpresas
feisty	luchadora
cave	cueva
rejuvenating	rejuvenecedor
pervasive	penetrante
hardball	béisbol
outstanding	sobresaliente
impenitent	impenitente
preposterous	absurdo
betrayal	traición
careless	descuidado
unwell	indispuesto
lags	desfases
liberate	liberar
disorganized	desorganizado
grotesque	grotesco
remission	remisión
lemon	limón
repulsing	repeliendo
irresolute	irresoluto
lucid	lúcido
inappropriate	inapropiado
insincerity	insinceridad
supurbly	increíblemente
pestilent	pernicioso
confound	confundir
convincingly	convincentemente
zealous	celoso
inimical	hostil
curt	brusco
disliking	desagrado
slaughtered	sacrificados
proving	prueba
patriotic	patriótico
remorseful	arrepentido
bores	taladros
pathetic	patético
smouldering	latente
flirty	coqueta
alarmed	alarmado
antiquated	anticuado
poky	diminuto
nastiness	suciedad
delay	retraso
lugubrious	lúgubre
succeed	éxito
addicting	adictivo
deviously	sinuosamente
vindictively	vengativamente
irrepressible	irreprimible
mesmerized	hipnotizado
laudably	laudablemente
subordinate	subordinado
entrapment	atrapamiento
worried	preocupado
damnably	detestablemente
promised	prometido
tickle	cosquillas
danken	húmedo
disturbance	perturbación
vainly	vanamente
disconcertingly	desconcertantemente
allegations	alegaciones
awkwardness	torpeza
prodigiously	prodigiosamente
outperformed	superado
flatteringly	halagadoramente
astonishing	asombroso
daringly	atrevidamente
soothe	calmar
wonder	preguntarse
affirmation	afirmación
flighty	frívolo
surreal	surrealista
ghastly	horrible
advantages	ventajas
unpleasantries	desagradables
obliterated	obliterado
steady	firme
wowed	sorprendió
cheated	engañado
agonize	agonizar
vibrating	vibrando
frown	ceño
trouble	problema
graciousness	gracia
creepy	horripilante
discourteous	descortés
ironically	irónicamente
derogatory	despectivo
approve	aprobar
nettlesome	irritante
inarticulate	inarticulado
maturity	madurez
finely	finamente
unwisely	imprudentemente
abundant	abundar
misleading	engañoso
overdone	exagerado
butcher	carnicero
peeled	pelado
static	estático
incongruously	incongruentemente
fabricate	fabricar
gaffe	patinazo
deplorably	deplorablemente
protect	proteger
anguish	angustia
gaining	negociación
exhaust	escape
enthusiasm	entusiasmo
enhanced	mejorado
grouchy	malhumorado
desperate	desesperado
pedantic	pedante
hostile	hostil
deceiving	engañoso
thrifty	ahorrativo
magnificence	magnificencia
rejection	rechazo
affliction	aflicción
unforgiving	implacable
cliched	cliché
hate	odio
hail	granizo
wonders	maravillas
tarnishes	empaña
falter	desfallecer
corrode	corroer
idolized	idolatrado
queer	extraño
uncivil	incivil
insufficiently	insuficientemente
perturbed	perturbado
marvels	maravillas
pathetically	patéticamente
overpriced	caro
disapointment	decepción
traction	tracción
scandalized	escandalizado
subsidizing	subvencionar
lividly	lívidamente
lurking	acecho
quaint	pintoresco
famished	famélico
sob	sollozo
pampers	mima
lover	amante
damaging	perjudicial
cheerful	alegre
magnificent	magnífico
flatter	halagar
solid	sólido
valuable	valioso
effortlessly	permitiendo
hatefully	odio
haunt	rondar
objection	objeción
servitude	servidumbre
hopeful	esperanzado
unselfish	altruista
hostility	hostilidad
failed	fracasado
asperse	hisopear
inopportune	inoportuno
bewail	llorar
hothead	exaltado
modern	moderno
mercifully	piadosamente
rigidness	rigidez
contrariness	contrariedad
silent	silencioso
exasperating	irritante
pillory	picota
detract	detraer
excellency	excelencia
harmful	perjudicial
goad	aguijón
fever	fiebre
nervousness	nerviosismo
erratic	errático
dismal	triste
fallen	caído
calm	calma
prejudices	prejuicios
crushed	aplastado
twinkly	brillante
satisfies	satisfecho
plush	felpa
durable	duradero
virtuously	virtuosamente
sidetrack	apartadero
tumultuous	tumultuoso
detestably	detestablemente
tedious	tedioso
infiltrator	infiltrado
distrusting	desconfiando
wonderously	maravillosamente
erodes	erosiona
heartbreaker	rompecorazones
rigid	rígido
aggravate	agravar
bereft	privado
licentiously	licenciosamente
staunch	firme
obscenely	obscenamente
miser	avaro
proficiently	soltura
humorous	humor
frustrations	frustraciones
fictitious	ficticio
supremely	supremamente
clique	camarilla
insanity	locura
timely	oportuno
captivating	seductor
ranting	desvaríos
luxury	lujo
disappoints	decepciona
gibber	farfullar
generosity	generosidad
flirt	coquetear
undisputed	indiscutible
bastards	bastardos
peril	peligro
prudent	prudente
grumble	queja
refreshed	refrescado
mushy	mollar
oppressive	opresivo
chafe	rozar
squabble	disputa
monotony	monotonía
diabolic	diabólico
importune	importunar
strife	contienda
mess	lío
swollen	hinchado
balanced	equilibrado
chilly	frío
wicked	malvado
doldrums	bache
stampede	estampida
dusty	polvoriento
wasting	perder
irony	ironía
leery	sospechoso
oppress	oprimir
flaunt	ostentar
undermine	minar
undercutting	subvaloración
smother	ahogar
racy	picante
inattentive	inatento
superbly	magníficamente
lamentably	lamentablemente
cost-effective	rentable
misfit	inadaptado
forsake	abandonar
easy	fácil
felonious	criminal
won	ganó
suave	afable
gloomy	triste
tender	tierno
skimpy	escaso
disadvantage	desventaja
vibrate	vibrar
violently	violentamente
stressful	estresante
spoilage	deterioro
shame	vergüenza
contentment	alegría
sever	cortar
quibbles	problemillas
frolic	fiesta
faithfully	fielmente
solicitously	solícita
progress	progreso
listless	apático
amicability	amabilidad
jealousy	celos
anti-white	anti-blanco
unworkable	impracticable
besmirch	manchar
object	objeto
misunderstandings	malentendidos
dissenter	disidente
charm	encanto
incessant	incesante
controversy	controversia
goof	bobo
insincere	insincero
relief	alivio
abolish	abolir
boring	aburrido
renown	renombre
astound	asombrar
cataclysmic	catastrófico
sneeringly	burlonamente
perplexed	perplejo
undercut	socavada
exorbitantly	exorbitantemente
downbeat	pesimista
unfortunate	desgraciado
noiseless	silencioso
anarchist	anarquista
appalling	espantoso
debase	degradar
elated	exaltado
insubstantial	insubstancial
supporter	partidario
blurring	desenfoque
cramp	calambre
perilously	peligrosamente
fine	fino
remunerate	remunerar
empathize	empatizar
spitefully	malévolamente
unequivocal	inequívoco
deprecate	desaprobar
fragile	frágil
rapture	rapto
fundamentalism	fundamentalismo
insolvent	insolvente
misaligned	desalineada
bristle	cerda
extremists	extremistas
reverent	reverente
bully	matón
one-sided	unilateral
dirty	sucio
spirited	enérgico
praise	alabanza
innovation	innovación
spiteful	malévolo
smell	olor
feasible	factible
chore	faena
turbulent	turbulento
sustainability	sostenibilidad
uncomfy	incómoda
warning	advertencia
curse	maldición
lean	magro
enrich	enriquecer
simplifying	simplificando
repugnance	repugnancia
incompetent	incompetente
layoff	despido
agony	agonía
impedance	impedancia
exalting	exaltando
conciliate	conciliar
unquestionable	incuestionable
beset	acosar
feint	finta
lifesaver	salvavidas
fervid	ardiente
bungler	chapucero
unconstitutional	inconstitucional
dismaying	desalentador
instantly	instantáneamente
togetherness	unión
regrettably	lamentablemente
anxious	ansioso
inaccuracies	inexactitudes
achievement	logro
pleasurably	agradablemente
resourceful	ingenioso
refresh	refrescar
devastate	devastar
stupid	estúpido
unrivaled	incomparable
tricked	engañado
strict	estricto
restless	inquieto
worked	trabajado
anti-proliferation	anti-proliferación
fleeting	fugaz
unpopular	impopular
perversity	perversidad
intoxicate	intoxicar
personalized	personalizado
betrays	traiciona
godsend	bendición
misrepresentation	falsificación
maneuverable	maniobrable
ingenuity	ingenio
freed	liberado
appreciatively	apreciativa
brutalize	embrutecer
wowing	sorprendente
crook	ladrón
hard-working	trabajador
filthy	inmundo
heartbreaking	angustioso
pickets	piquetes
invalid	inválido
knotted	anudado
radiant	radiante
awesomeness	genialidad
disadvantages	desventajas
flattering	halagüeño
incivility	incivilidad
hedonistic	hedonista
decisive	decisivo
irretrievable	irreparable
defeat	derrota
foresight	previsión
inundated	inundados
solicitous	solícito
splendor	esplendor
die-hard	empedernido
enjoyment	disfrute
exuberance	exuberancia
panick	pánico
regal	regio
imaginative	imaginativo
poignant	conmovedor
debts	deudas
hated	odiado
paupers	pobres
crass	craso
commotions	conmociones
wreck	naufragio
secure	asegurar
sin	pecado
ignorance	ignorancia
buckle	hebilla
debilitate	debilitar
fond	aficionado
critical	crítico
state-of-the-art	puntera
spellbinding	fascinante
garish	llamativo
mundane	mundano
alienate	enajenar
confront	criminal
constructive	constructivo
fervidly	fervientemente
pinnacle	pináculo
excuses	excusas
galling	mortificante
incognizant	ignorante
tragically	trágicamente
gaiety	alegría
heedless	desatento
visionary	visionario
keenly	agudamente
sully	manchar
hurting	lastimar
upgradeable	actualizable
irregularity	irregularidad
liars	mentirosos
risks	riesgos
culprit	culpable
misery	miseria
liable	responsable
excelent	excelente
revolutionary	revolucionario
gabble	parloteo
pugnacity	pugnacidad
impatiently	impacientemente
impassioned	apasionado
bullish	alcista
pleasantly	agradablemente
backbite	murmurar
burns	quemaduras
tough	duro
gleeful	jubiloso
struggle	lucha
clueless	despistados
discouraging	desalentador
capitulate	capitular
cure-all	panacea
domineer	tiranizar
skeptical	escéptico
fallaciousness	falacia
harmonious	armonioso
violent	violento
calamity	calamidad
willing	dispuesto
obstruct	obstruir
vague	vago
allegation	allegatio
midget	enano
untrue	falso
indulgence	indulgencia
volatility	volatilidad
miraculously	milagrosamente
unobserved	desapercibido
affront	afrenta
reassurance	seguridades
disturbing	perturbador
lure	señuelo
scum	escoria
spotty	manchado
fascinate	fascinar
aground	encallado
pernicious	pernicioso
stutter	tartamudeo
antipathy	antipatía
uncomfortably	incómodamente
breaking	rompiendo
neat	ordenado
bogus	falso
indiscriminate	indistinto
lost	perdido
ignominious	ignominioso
uneasiness	inquietud
improved	mejorado
unwise	imprudente
lumpy	grumoso
coherence	coherencia
instability	inestabilidad
acrid	acre
disruption	trastorno
abundance	abundancia
rant	despotricar
complementary	complementario
grouch	gruñón
exaggeration	exageración
turmoil	confusión
untruthful	mentiroso
endorsement	endoso
decay	decadencia
alienated	alienado
paranoid	paranoico
fervent	ferviente
joyously	gozosamente
fetid	fétido
trophy	trofeo
rut	rodera
conflicts	conflictos
defensive	defensiva
suspicions	sospechas
pamper	mimar
wrong	mal
tarnished	empañado
enthusiastic	entusiasta
gauche	desmañado
coldly	fríamente
fictional	ficticio
vanity	vanidad
decisiveness	decisión
uprising	levantamiento
fearsome	temible
beastly	bestial
bash	fiesta
shadowy	sombrío
imminently	inminentemente
shiver	tiembla
obtainable	asequible
neglected	descuidado
iniquity	iniquidad
anxiousness	ansiedad
incense	incienso
pretense	pretensión
accessible	accesible
maddeningly	exasperantemente
heartening	alentador
suffice	baste
appalled	aterrado
craziness	locura
catastrophe	catástrofe
subdued	suave
despised	despreciado
compassionate	compasivo
suffered	sufrido
deadbeat	perezoso
benevolent	benévolo
positively	afirmativamente
marvelously	maravillosamente
freedoms	libertades
wrongful	ilegal
straining	esfuerzo
desultory	inconexo
selfishly	egoístamente
grumpily	gruñonamente
immovable	inamovible
dissidents	disidentes
opposition	oposición
exceeding	exceda
coupists	golpistas
propitious	propicio
cowardly	cobarde
better	mejor
incoherently	incoherentemente
surrender	rendición
lead	conducir
wobble	tambalearse
toughness	tenacidad
congratulation	felicitación
excuse	excusa
grievance	queja
revolt	revuelta
disorderly	desordenado
ire	ira
satirize	satirizar
aggravation	agravación
tantalizing	tentadora
jealously	celosamente
cloudy	nublado
bulkiness	volumen
presumptuous	presuntuoso
snarl	gruñido
mature	maduro
amicably	amigablemente
refuses	niega
wonderfully	maravillosamente
eyesore	monstruosidad
bleeds	sangra
rift	grieta
dissuade	disuadir
restructuring	reestructuración
malodorous	maloliente
shrilly	estridente
insightfully	perspicacia
stumbles	tropieza
warlike	belicoso
impunity	impunidad
joke	broma
triumph	triunfo
batty	chalado
degeneration	degeneración
overtaxed	sobrecargado
outstrip	aventajar
atrocity	atrocidades
wilt	marchitar
instigator	instigador
mock	simulado
great	gran
astonish	asombrar
squeak	chirrido
overwhelmingly	abrumadoramente
showdown	confrontación
provocation	excitación
farce	farsa
siege	cerco
inconsequent	inconsecuente
fallaciously	falsamente
cleared	despejado
tenuously	tenuemente
guiltless	inocente
defender	defensor
antagonism	antagonismo
failing	defecto
thankless	ingrato
exceptionally	excepcionalmente
futile	fútil
angelic	angelical
exultingly	exultantes
unaffected	inafectado
trap	trampa
cheapen	abaratar
lionhearted	valiente
poison	tóxico
pleasant	agradable
manipulators	manipuladores
shemale	transexual
mashed	puré
worthy	digno
imminence	inminencia
sorely	muy
disillusionment	desilusión
improvements	mejoras
sleazy	sórdido
fracture	fractura
aspire	aspirar
grateful	agradecido
swelling	hinchazón
baffled	desconcertado
strident	estridente
wrest	arrebatar
promise	promesa
picketing	piquetes
penalty	pena
feat	hazaña
discontent	descontento
forsaken	abandonado
unwavering	inquebrantable
blab	cotilla
scratches	arañazos
disadvantageous	desventajoso
delicacy	delicadeza
tepid	tibio
pales	palidece
deserving	digno
vibration	vibración
mockery	burlas
stupidly	estúpidamente
delaying	dilatoria
lush	exuberante
carnage	carnicería
preferring	prefiriendo
outperforming	superando
raving	delirio
sharply	bruscamente
treasure	tesoro
glisten	relucir
disrespectful	irrespetuoso
tank	tanque
effusively	efusivamente
nauseatingly	asquerosamente
dishonest	deshonesto
unassailable	inatacable
hapless	desventurado
dud	falso
precious	precioso
miracles	milagros
abounds	abunda
precisely	precisamente
needless	innecesario
dim	apagarse
superficially	superficialmente
righteousness	justicia
unthinkable	inconcebible
restlessness	inquietud
raging	rabioso
killer	asesino
temerity	temeridad
repressive	represivo
ordeal	ordalías
deceitful	engañoso
perfidious	pérfido
wretchedness	miseria
harmonize	armonizar
testy	irascible
daunt	acobardar
repudiation	repudio
witty	ingenioso
comely	gentil
foremost	primero
rhetorical	retórico
excessively	excesivamente
self-sufficiency	autosuficiencia
indiscriminating	indiscriminada
disbeliever	incrédulo
sucked	aspirado
starvation	inanición
exhausted	agotado
disgust	asco
interesting	interesante
dispirited	desalentado
refutes	refuta
wretchedly	miserablemente
deform	deformar
blaspheme	blasfemar
insolent	insolente
exuberantly	exuberantemente
failure	fracaso
negativity	negatividad
enjoys	disfruta
fustigate	fustigar
record-setting	récord
madly	locamente
draining	drenaje
fail	fallar
significant	significativo
ludicrous	ridículo
hates	odios
extermination	exterminio
marvel	maravilla
bigotry	intolerancia
vex	vejar
attraction	atracción
stuttered	tartamudeado
fascinatingly	fascinantemente
heartbreakingly	desgarradoramente
over-valuation	sobrevaloración
spotless	inmaculado
delusional	delirante
infection	infección
unemployed	parados
privileged	privilegiado
ambivalence	ambivalencia
gratifies	gratifica
undermining	minando
symptoms	síntomas
ecstasies	éxtasis
conspirator	conspirador
conflict	conflicto
invincible	invencible
brighten	aclarar
emphatic	enfático
intractable	intratable
covetous	codicioso
disdainfully	desdeñosamente
threatening	amenazante
pig	cerdo
epidemic	epidemia
greed	codicia
speedy	veloz
anger	cólera
detest	detestar
assuring	asegurando
discontinuous	discontinuo
disagreeing	desacuerdo
felicitous	feliz
rapturous	delirante
expunge	borrar
awesome	impresionante
banalize	vulgarizar
cheer	humor
capability	capacidad
addicted	adicto
disarray	desorden
isolate	aislar
prosperous	próspero
glamorous	atractivo
concession	concesión
mistress	amante
drunk	borracho
elegance	elegancia
distorted	distorsionado
freak	monstruo
abyss	abismo
savagery	salvajismo
impartially	imparcialmente
inconstant	inconstante
detracting	desmerecer
hangs	cuelga
ax	hacha
vociferous	vociferante
ugly	feo
humming	zumbador
gladden	alegrar
hysterical	histérico
lurch	estacada
perversion	perversión
blind	ciego
slut	puta
creaking	crujiente
effusion	efusión
shortcoming	defecto
gripes	cólicos
mortification	mortificación
comfortably	cómodamente
incongruous	incongruente
spurious	espurio
acclamation	aclamación
exceeds	excede
handy	práctico
avalanche	avalancha
enslave	esclavizar
extraneous	extraño
wholesome	saludable
belligerence	beligerancia
foulness	asquerosidad
bruised	magullado
exile	exilio
conspire	conspirar
embarrassingly	vergonzosamente
regretful	pesaroso
squeaks	chirridos
posturing	posturas
bloody	sangriento
lapsed	caducado
soundly	sólidamente
unusually	particularmente
reckless	temerario
molest	molestar
aspersion	aspersión
revenge	venganza
homage	homenaje
relish	saborear
outmoded	anticuado
nightmare	pesadilla
treachery	traición
gratification	gratificación
thrillingly	estremecedoramente
authentic	auténtico
jeeringly	burlonamente
assassin	asesino
mesmerizing	fascinante
occlude	ocluir
overweight	sobrepeso
ungovernable	ingobernable
unlawful	ilegal
frenzied	frenético
incompetently	incompetente
subservience	subordinación
debilitating	debilitante
beguile	engañar
weary	cansado
abrasive	abrasivo
dignify	dignificar
biased	parcial
fidget	agitarse
tingling	hormigueo
agreeableness	agradabilidad
useful	útil
strain	tensión
screwed-up	atornillado-up
languor	languidez
destroy	destruir
mockingly	burlonamente
rightfully	legítimamente
drowning	ahogo
regrettable	lamentable
hustler	estafador
recalcitrant	recalcitrante
gusto	entusiasmo
fusty	mohoso
allergies	alergias
industrious	industrioso
accusation	acusación
scrambling	aleatorización
incompatibility	incompatibilidad
temper	genio
mordant	mordaz
sag	hundimiento
incredible	increíble
war-like	bélica
poisonously	venenosamente
enmity	enemistad
humourous	chistoso
nauseating	nauseabundo
allege	alegar
tenderly	ternura
works	obras
warmth	calor
complements	complementos
darken	oscuro
fearful	temeroso
scarcely	escasamente
prudence	prudencia
vagueness	vaguedad
stubbornness	testarudez
sermonize	sermonear
scourge	azote
twists	torceduras
sophisticated	sofisticado
cynicism	cinismo
bad	malo
vibrated	vibrado
overkill	exageración
parasite	parásito
improbability	improbabilidad
loyalty	lealtad
unuseably	inutilizable
ruthlessness	crueldad
rewardingly	recompensadoramente
leaks	fugas
flounder	platija
macabre	macabro
passionate	apasionado
cons	contras
aversion	aversión
oversights	descuidos
dissention	discordia
gold	oro
acridly	acremente
outrageously	atrozmente
insensitive	insensible
jagged	dentado
flagrant	flagrante
entertain	entretener
upgraded	actualización
shun	rehuir
unclean	sucio
brashness	desenvoltura
rational	racional
complaint	queja
honest	honesto
radically	radicalmente
unforgettable	inolvidable
swiftness	rapidez
lecherous	lascivo
imprudent	imprudente
imposition	imposición
contradiction	contradicción
variety	variedad
idol	ídolo
die	morir
reasonable	razonable
protests	protestas
pessimistic	pesimista
anomaly	anomalía
vexation	vejación
lewd	lascivo
meddlesome	entrometido
ironic	irónico
stinging	escozor
elegantly	elegantemente
chic	elegante
useless	inútil
inexorably	inexorablemente
intelligent	inteligente
fright	susto
commonplace	vulgar
worthlessness	inutilidad
venom	veneno
preoccupy	preocupar
virulent	virulento
fruitlessly	infructuosamente
infirm	enfermizo
perilous	peligroso
egotistical	ególatra
ingenuous	ingenuo
immature	inmaduro
peculiarly	extrañamente
traitorous	traidor
effectual	eficaz
headway	progreso
malicious	malicioso
retards	retardados
madder	rubia
chronic	crónico
senile	senil
stresses	tensiones
interference	interferencia
taunt	pulla
trustworthiness	integridad
cunt	coño
disaccord	desacuerdo
aching	dolor
disillusion	desilusión
dreadfully	horrorosamente
droop	caer
threaten	amenazar
posh	elegante
wasted	desaprovechado
restful	sosegado
disapprobation	desaprobación
bane	perdición
revere	reverenciar
displease	desagradar
incredulously	incredulidad
discord	discordia
inhuman	inhumano
lonesome	solitario
amiability	amabilidad
prideful	orgulloso
dismissively	despectivamente
securely	segura
uproarious	estruendoso
distraction	distracción
indignant	indignado
mischief	travesura
luster	lustre
intolerance	intolerancia
sap	savia
aggressiveness	agresividad
nepotism	nepotismo
affectionate	cariñoso
idiotically	idiota
disconsolate	desconsolado
freaks	monstruos
sumptuous	suntuoso
rhapsodize	extasiarse
grumpy	gruñón
rubbish	basura
frantic	frenético
vigilance	vigilancia
gall	hiel
dexterously	diestramente
tumble	caer
understandable	comprensible
troubles	problemas
troublingly	inquietantemente
contamination	contaminación
contaminate	contaminar
long-winded	prolijo
idyllic	idílico
sty	pocilga
detriment	detrimento
salute	saludo
educated	educado
appall	espantar
dissemble	disimular
gawky	desgarbado
breaks	descansos
excellant	excelente
fairness	justicia
addict	adicto
streamlined	aerodinámico
conspiracies	conspiraciones
humble	humilde
crisp	crujiente
seedy	sórdido
unorthodoxy	heterodoxia
dunce	burro
froze	congeló
meticulously	meticulosamente
disappointed	decepcionado
scar	cicatriz
unrest	disturbios
rash	erupción
bravery	valentía
glitter	purpurina
killing	matanza
levity	ligereza
noise	ruido
woo	cortejar
innuendo	insinuación
anarchy	anarquía
guilt	culpa
idolize	idolatrar
suspicion	sospecha
faithless	desleal
derision	burla
triumphal	triunfal
grumpier	gruñón
inextricably	inextricablemente
deplete	agotar
excited	excitado
cleverly	inteligentemente
dilemma	dilema
suffering	sufrimiento
leakages	fugas
touchy	quisquilloso
affirmative	afirmativo
subjected	sometido
proven	probado
plea	súplica
supports	soportes
pauper	pobre
aspirations	aspiraciones
fanfare	fanfarria
grieving	duelo
clear	claro
frenzy	frenesí
sinfully	pecaminosamente
seethe	bullir
world-famous	famosa
sickening	nauseabundo
reviled	denostado
infuriatingly	exasperantemente
fanciful	imaginario
blinding	cegador
grate	reja
inveigle	seducir
unmoved	impasible
horrendously	horrendamente
undefined	indefinido
bondage	esclavitud
adulterated	adulterada
godlike	divino
nurturing	crianza
maniacal	maníaco
smut	tizón
trusty	fiel
breathtakingly	impresionantemente
collusion	colusión
sceptical	escéptico
flaws	defectos
exaltedly	exaltadamente
nefarious	vil
battering	maltrato
celebrate	celebrar
malevolence	malevolencia
resignation	renuncia
encouraging	alentador
disgracefully	vergonzosamente
quiet	tranquilo
unavailable	indisponible
dazzled	deslumbrado
uproariously	ruidosamente
depressing	deprimente
defame	difamar
civility	civilidad
sincerity	sinceridad
silly	tonto
invective	invectiva
snappy	rápido
malady	enfermedad
prosperity	prosperidad
attacks	ataques
issue	cuestión
underestimate	subestimar
undecided	indeciso
reform	reforma
scrambles	revuelve
aggressor	agresor
harridan	bruja
amusing	divertido
peach	melocotón
refined	refinado
underdog	desvalido
ache	dolor
rewarding	provechoso
deviation	desviación
irrecoverably	irrecuperable
impinge	invadir
sullen	hosco
insulted	insultado
indifference	indiferencia
precarious	precario
perfection	perfección
incomparably	incomparablemente
crooked	torcido
smelt	olido
fret	traste
cannibalize	canibalizar
frets	trastes
uncouth	grosero
incoherent	incoherente
hatefulness	odiosidad
carp	carpa
pamperedly	mimado
restrictive	restrictivo
coercion	coacción
purify	purificar
disparage	menospreciar
statuesque	estatuario
erroneous	erróneo
smutty	tiznado
dazzling	deslumbrante
debauchery	libertinaje
revive	reanimar
free	gratis
well	bien
stigmatize	estigmatizar
hazard	peligro
bargain	ganga
racists	racistas
malice	malicia
biases	sesgos
audaciously	audazmente
thug	matón
defiance	desafío
belated	tardío
unknown	desconocido
overdue	atrasado
cute	lindo
magnificently	magníficamente
available	disponible
unpredictable	imprevisible
whimper	gemido
achievible	alcanzable
cheater	tramposo
ignominy	ignominia
darkness	oscuridad
unfamiliar	desconocido
inequality	desigualdad
audacity	audacia
disagreement	desacuerdo
insincerely	insinceramente
victimize	victimizar
slothful	perezoso
repulsive	repulsivo
gallantly	gallardamente
perverted	pervertido
beautiful	hermoso
prestigious	prestigioso
demolish	demoler
misalign	desalinear
redundancy	redundancia
oppressors	opresores
desecrate	profanar
lackluster	deslucido
undetermined	indeterminado
averse	contrario
gorgeous	maravilloso
celebrated	célebre
inefficiency	ineficacia
stimulating	desafiante
savages	salvajes
vivid	vívido
objections	objeciones
ebullience	entusiasmo
ignominiously	ignominiosamente
dirt	suciedad
enticingly	seductoramente
frustrates	frustra
adamant	firme
dings	abolladuras
cocky	gallito
ugh	uf
intriguing	secreto
inexcusably	inexcusablemente
moronic	imbécil
extravagantly	extravagantemente
smear	frotis
rage	rabia
dented	abollado
short-lived	efímero
scoffingly	burlón
unpleasant	desagradable
scold	regaño
two-faced	hipócrita
wisely	prudentemente
civilize	civilizar
miracle	milagro
negligence	negligencia
prosecute	procesar
devilish	diabólico
fast-paced	acelerado
clarity	claridad
unsure	inseguro
paradoxically	paradójicamente
insupportably	insoportablemente
assure	asegurar
effusive	efusivo
uneconomical	antieconómico
horrified	horrorizado
skillful	hábil
cuss	maldecir
fury	furia
promoter	promotor
satisfactory	satisfactorio
loving	amoroso
nag	rocín
clamorous	clamoroso
earnestly	formalmente
imaculate	impecable
un-viewable	no-visible
erode	erosionar
outraged	indignados
filth	inmundicia
weak	débil
guidance	dirección
ached	dolía
picturesque	pintoresco
expertly	experta
horrific	horrendo
obsessions	obsesiones
wise	prudente
repulsiveness	repulsividad
reprehension	reprensión
enlightenment	ilustración
daring	atrevido
embolden	envalentonar
yawn	bostezo
inaccuracy	inexactitud
effrontery	descaro
derisive	burlón
devilment	diablura
pinch	pellizcar
risk	riesgo
warily	cautela
ineffectual	ineficaz
fame	fama
death	muerte
menace	amenaza
stew	estofado
avarice	avaricia
disingenuous	falso
replaceable	reemplazable
scrap	residuos
dejectedly	abatido
ailing	enfermo
unequal	desigual
detesting	detestando
redundant	redundante
defamatory	difamatorio
swelled	engrosado
well-wishers	bienquerientes
hearten	corazón
imperfection	imperfección
defiler	profanador
aches	dolores
emasculate	castrar
irreplaceable	irremplazable
stymied	obstaculizado
willingness	disposición
decrement	decremento
falsify	falsificar
craze	manía
comical	cómico
supple	flexible
tortuous	tortuoso
undaunted	impávido
prominence	prominencia
adoring	cariñoso
unravel	desvela
boredom	aburrimiento
roadblocks	usted
confuse	confuso
bashful	tímido
mocks	burla
unhappily	infelizmente
efficient	eficiente
abscond	fugarse
saggy	flaccidez
miseries	miserias
admonishingly	admonitorio
problems	problemas
aggrieve	ofender
subversion	subversión
blameless	irreprochable
degradation	degradación
patriot	patriota
forbid	prohibir
inordinate	desordenado
dead	muerto
denunciation	denuncia
unsettlingly	perturbadoramente
hurt	daño
strangle	estrangular
spoils	botín
ample	amplio
exaltation	exaltación
denigrate	denigrar
skilled	entrenado
worsen	exacerbar
phobia	fobia
diligent	diligente
paltry	miserable
supported	apoyado
purposeful	útil
boastful	jactancioso
appeal	apelación
tease	embromar
rocky	rocoso
raped	violada
militancy	militancia
coerce	obligar
deterrent	disuasivo
self-coup	autogolpe
tetchily	irasciblemente
enjoyed	disfrutado
stall	establo
veritable	verdadero
beggar	mendigo
misaligns	desalinea
throb	latido
sagging	hundimiento
annoyingly	molestamente
proper	correcto
peace	paz
foul	falta
cherish	apreciar
gasp	grito
immaculate	inmaculado
slanderously	blasfemados
declining	declinante
pity	lástima
greedy	codicioso
cheesy	caseoso
apathetically	apatía
beseech	implorar
comfort	confort
predicament	predicamento
resplendent	resplandeciente
ardently	ardientemente
dent	abolladura
draconian	draconiana
fabulous	fabuloso
exceptional	excepcional
ridiculous	ridículo
merry	alegre
portable	portátil
negation	negación
intimidation	intimidación
coward	cobarde
panders	alcahuetes
sicken	enfermar
incorrigibly	incorregible
irreproachable	irreprochable
gainfully	remunerado
awarded	otorgado
unfaithful	infiel
dismissive	desdeñoso
splatter	salpicadura
redeeming	redentor
capriciousness	capricho
unbiased	imparcial
snare	lazo
excite	excitar
soulful	sentimental
flare	llamarada
brave	valiente
deprive	privar
election-rigger	elecciones-instalador
despairing	desesperado
consistent	consistente
obstinate	obstinado
nobly	noble
fatty	graso
implausible	increíble
earnestness	seriedad
noteworthy	notable
disobedient	desobediente
accusations	acusaciones
lone	solitario
disobey	desobedecer
glee	júbilo
mesmerize	hipnotizar
complaining	quejarse
thrilled	encantados
sluts	zorras
forlorn	abandonado
ruffian	rufián
gratifying	gratificante
syndrome	síndrome
nifty	elegante
hot	caliente
extoll	ensalzar
loveliness	hermosura
illustrious	ilustre
staid	serio
deplore	deplorar
counter-attacks	contraataques
frighteningly	pavorosamente
earnest	serio
obnoxiously	odiosamente
vibrantly	vibrantemente
aborts	aborta
embarrassment	vergüenza
isolation	aislamiento
awkward	incómodo
pugnacious	pugnaz
versatile	versátil
pamperedness	mimo
divisive	divisivo
sufficiently	suficientemente
overtaking	adelantamiento
deaf	sordo
thrilling	electrizante
readable	legible
inspiration	inspiración
opulent	opulento
cussed	terco
bereave	privar
faltered	tambaleado
lagging	retraso
enjoin	ordenar
spade	pala
demean	degradar
disgustingly	asquerosamente
savior	salvador
dominate	conquista
improbably	improbablemente
masterful	maestro
patient	paciente
dullard	zoquete
impressive	impresionante
hard	duro
punish	castigar
untenable	insostenible
soft	suave
distastefully	desagrado
lustrous	lustroso
hogs	cerdos
flares	bengalas
deceit	engaño
accusing	acusando
unnerving	enervante
splendid	espléndido
disapproval	desaprobación
symptom	síntoma
calumnies	calumnias
dripped	goteado
repudiate	repudiar
fleeing	huyendo
agonies	agonías
temptingly	tentadoramente
swift	rápido
relentless	implacable
happy	feliz
hideously	horriblemente
doubtless	indudable
favor	favorecer
reprehensible	censurable
apprehensively	aprensión
flees	huye
onerously	onerosa
risky	arriesgado
mastery	maestría
inflationary	inflacionista
gimmicked	trucada
adored	adorado
abort	abortar
dungeon	mazmorra
passiveness	pasividad
shoddy	pacotilla
forgetful	olvidadizo
vengeful	vengativo
shrew	musaraña
ill-favored	feo
exhilarating	estimulante
smoothly	suavemente
resounding	rotundo
sickeningly	repugnantemente
befoul	ensuciar
coercive	coactivo
nonsense	disparates
refuse	rechazar
malign	maligno
indecency	indecencia
undisputable	indiscutible
desolation	soledad
needy	necesitado
obnoxious	desagradable
callous	calloso
split	división
deficiency	deficiencia
contrived	artificial
forceful	enérgico
err	errar
drop-outs	abandonos
cravenly	cobardemente
afraid	miedo
needlessly	innecesariamente
productive	productivo
cramped	estrecho
infamous	infame
gaff	garfio
kills	muertes
energize	energizar
regrets	excusas
scandalous	escandaloso
humid	húmedo
jeer	burla
dangerous	peligroso
eased	aliviado
individualized	individualizados
casualty	víctima
accurate	exacto
titillate	excitar
conflicting	contradictorio
unfinished	inconcluso
tenacious	tenaz
impugn	impugnar
stringently	rigurosamente
dragged	arrastrado
irksome	molesto
unjustified	injustificado
reactionary	reaccionario
slave	esclavo
master	maestro
puzzling	misterioso
prize	premio
compassion	compasión
expropriation	expropiación
inclement	inclemente
protesting	protestar
costly	costoso
imperfectly	imperfectamente
autocrat	autócrata
wrongly	erróneamente
insulting	insultante
hastily	precipitadamente
unquestionably	incuestionablemente
infiltrators	infiltrados
dick	polla
inflammatory	inflamatorio
compliment	cumplido
onerous	oneroso
irresponsibly	irresponsable
luxuriate	deleitarse
illness	enfermedad
precipitate	precipitar
zealot	fanático
unorthodox	heterodoxo
worryingly	preocupante
worries	preocupaciones
wreak	infligir
sensationally	sensacionalmente
handsomely	generosamente
tempest	tempestad
reject	rechazar
pest	parásito
exasperatingly	exasperantemente
bitchy	perra
tragedy	tragedia
agonizing	agonizante
heinous	atroz
worthiness	mérito
apocalypse	apocalipsis
quarrel	pelea
commitment	compromiso
defrauding	defraudar
degradingly	degradantemente
trashed	destrozado
selfishness	egoísmo
rectify	rectificar
water-down	agua-down
joyfully	alegremente
impertinent	impertinente
punctual	puntual
imbalance	desequilibrio
irked	irritado
nosey	fisgón
tenacity	tenacidad
abruptly	abruptamente
excels	sobresale
top	superior
exuberant	exuberante
relent	ablandarse
mistrust	desconfianza
supremacy	supremacía
subservient	subordinado
amazes	sorprende
issues	cuestiones
presumptuously	presuntuosamente
prefers	prefiere
hysteria	histeria
benefits	beneficios
misfortune	desgracia
glimmering	resplandeciente
irrelevant	irrelevante
pale	pálido
pan	cacerola
accomplished	cumplido
fantastic	fantástico
crashing	estrellarse
optimistic	optimista
dissolute	disoluto
disgruntled	descontento
rosy	rosado
lethargy	letargo
unreasonable	irrazonable
zealously	celosamente
abominate	abominar
jumpy	asustadizo
elite	élite
sparkle	brillo
fatalistic	fatalista
innocuous	inocuo
carefree	despreocupado
preferably	preferiblemente
flee	huir
imprecate	imprecar
stink	hedor
empathy	empatía
dragoon	dragón
prodigious	prodigioso
skeptic	escéptico
affinity	afinidad
undesirable	indeseable
sneaky	furtivo
victorious	victorioso
exquisitely	exquisitamente
insanely	locamente
bruising	hematomas
yay	toma
blame	culpa
refreshing	refrescante
concen	concan
abysmal	abismal
applaud	aplaudir
sober	sobrio
effective	efectivo
traumatized	traumatizado
reprove	reprender
gratifyingly	gratificantemente
uproar	estruendo
murderer	asesino
bump	chichón
kill	matar
mistrustful	desconfiado
gorgeously	magníficamente
inefficient	ineficiente
violators	violadores
aggravating	agravante
inspirational	inspirado
disarm	desarmar
indecent	indecente
priceless	inestimable
troubling	preocupante
uneven	desigual
vibrates	vibra
enjoyably	divertida
subsidize	subvencionar
swank	presumir
bonkers	loco
obscured	oscurecido
qualm	náusea
ugliness	fealdad
wrinkled	arrugado
deject	presar
discontented	descontento
lethal	letal
righteously	rectamente
impiety	impiedad
stimulate	estimular
angry	enojado
liking	gusto
important	importante
unprofitable	improductivo
transgression	transgresión
snags	inconvenientes
devastatingly	devastadoramente
bitter	amargo
valiant	valiente
harpy	arpía
perfect	perfecto
discordant	discordante
all-around	total
intransigence	intransigencia
destabilisation	desestabilización
weep	llorar
discourage	desalentar
painful	doloroso
hoard	acumulación
grin	sonrisa
corrupt	corrupto
despotism	despotismo
success	éxito
weaknesses	debilidades
multi-polarization	multipolarización
disputed	disputa
superficiality	superficialidad
fissures	fisuras
swamped	inundado
maladjusted	inadaptado
forbidden	prohibido
hurtful	hiriente
flourishing	floreciente
unfulfilled	incumplida
agreeably	agradablemente
inescapably	ineludiblemente
well-mannered	educado
barren	bares
fallacies	falacias
inefficiently	ineficientemente
brutalities	brutalidades
cool	fresco
doubt	duda
unsuspecting	desprevenido
stench	hedor
worse	peor
tangled	enredado
revolutionized	revolucionado
flakey	escamosa
excitement	emoción
trickery	trampa
interruption	interrupción
miserably	tristemente
leaky	agujereado
morality	moralidad
impetuous	impetuoso
wrip	pida
bless	bendecir
unfeeling	insensible
assurance	garantía
pertinacious	pertinaz
nagging	persistente
shunned	rechazado
slur	calumnia
rifts	divisiones
exalted	exaltado
traumatize	traumatizar
heartless	insensible
fastidious	fastidioso
barbarous	bárbaro
shamefulness	vergüenza
simplify	simplificar
reaffirm	reafirmar
intimidatingly	intimidantemente
overstatement	exageración
celebration	celebración
accolade	premio
crap	mierda
terrorize	aterrorizar
shocking	chocante
effectively	eficazmente
rascal	bribón
blah	bla
motivated	motivado
disrespecting	irrespetando
unlawfulness	ilegalidad
inhospitable	hostil
stiflingly	insoportablemente
heaven	cielo
overacted	sobreactuado
expulse	expulsar
tempting	tentador
comfortable	cómodo
rhetoric	rhetorica
shark	tiburón
feasibly	factiblemente
foe	enemigo
hissing	silbido
prohibitive	prohibitivo
mischievous	travieso
scuffs	desgastes
correct	correcto
insults	insultos
sugar-coated	azucarado
mordantly	mordazmente
denunciations	denuncias
evocative	evocador
insubordinate	insubordinado
disordered	desordenado
dissonantly	disonantemente
merrily	alegremente
polite	educado
blossom	flor
flabbergasted	asombrado
cleanliness	limpieza
covenant	pacto
vouchsafe	conceder
violator	violador
wrought	forjado
deviate	desviarse
dizzy	mareado
unwelcome	molesto
scenic	escénico
retaliatory	vengativo
injustice	injusticia
devout	devoto
slack	flojo
disable	inhabilitar
depression	depresión
conspicuously	deberes
magical	mágico
inimically	hostilmente
facetious	chistoso
insurmountably	insuperablemente
inexpertly	inexpertamente
scaly	escamoso
dissident	disidente
stubbornly	tercamente
reconcile	reconciliar
toll	peaje
heretic	hereje
downfall	caída
loneliness	soledad
inspiring	inspirador
prefered	preferida
extol	ensalzar
snagged	enganchado
terrorism	terrorismo
safe	seguro
glow	brillar
submissive	sumiso
wily	astuto
enrapture	arrebatar
sickly	enfermizo
evenly	igualmente
overwhelmed	abrumado
creative	creativo
overpower	dominar
fortitude	fortaleza
multi-purpose	multiuso
discriminatory	discriminatorio
noises	ruidos
revulsion	repugnancia
liberation	liberación
smartly	inteligentemente
pretend	pretender
proprietary	propietario
violation	violación
beloved	amado
geeky	geek
betrayals	traiciones
fidgety	nervioso
eschew	evitar
tortures	torturas
caricature	caricatura
qualified	calificado
severity	severidad
inefficacious	ineficaz
overshadow	eclipsar
faith	fe
entice	atraer
desiccate	desecar
abomination	abominación
concerned	preocupado
supporting	apoyando
cautionary	advertencia
itchy	picante
spiritual	espiritual
desperately	desesperadamente
estranged	distanciado
sweetheart	novio
gibberish	algarabía
stooges	chiflados
irate	airado
abrade	desgastar
imprudence	imprudencia
drunkard	borracho
renunciation	renuncia
bothersome	molesto
dishonesty	deshonestidad
outrages	ultrajes
mistakes	errores
venomously	venenosamente
liability	responsabilidad
ambivalent	ambivalente
scoff	burlarse
questionable	dudoso
rich	rico
brutish	brutal
slime	limo
gracefully	graciosamente
relaxed	relajado
rejects	rechaza
jabber	farfullar
entrap	entrampar
upheld	sostenida
delirious	delirante
offend	ofender
profanity	blasfemia
damning	condenatorio
downhearted	desanimado
advanced	avanzado
occluding	oclusión
ripped	rasgado
torture	tortura
drains	desagües
inadequately	inadecuadamente
justly	justamente
discouragingly	desalentadoramente
musty	mohoso
pandemonium	pandemonio
wondrous	maravilloso
setbacks	contratiempos
tawdry	cursi
romantically	románticamente
inconvenience	inconveniencia
overthrow	derrocamiento
obstinately	obstinadamente
shady	sombreado
straggle	rezagarse
awfulness	horror
extraordinarily	extraordinariamente
lying	acostado
qualify	calificar
groundless	infundado
conceited	presumido
pain	dolor
wonderous	maravillosa
ease	facilidad
renaissance	renacimiento
resourcefulness	inventiva
accusingly	acusatoriamente
rightly	correctamente
bothers	molesta
intricate	intrincado
furious	furioso
rip-off	estafa
desolate	solitario
bumpy	desigual
ready	listo
wastefulness	residuos
radicals	radicales
backwoods	rústico
faulty	defectuoso
empower	autorizar
brilliances	brillos
disallow	rechazar
crashed	estrellado
disconcert	desconcertar
fair	feria
ruthless	implacable
suffers	sufre
personages	personajes
cushy	cómodo
pleased	satisfecho
ineffectively	ineficazmente
hiss	silbido
impaired	deterioro
hype	bombo
depressingly	depresivamente
inequities	desigualdades
occluded	ocluido
prate	prateek
hindrance	obstáculo
naïve	ingenuo
run-down	deteriorado
uncomfortable	incómodo
arduously	arduamente
dents	abolladuras
acclaimed	aclamado
blur	mancha
tantalizingly	tentadoramente
botch	chapucería
sore	llaga
adulteration	adulteración
favored	favorecido
stiff	endurecer
jubilant	jubiloso
stealing	robo
extremism	extremismo
decline	disminución
alarming	alarmante
overthrows	derrocamientos
subversive	subversivo
renounce	renunciar
weaken	débil
difficult	difícil
hatred	odio
delusions	ilusiones
disregard	indiferencia
killjoy	aguafiestas
damage	daño
calumny	calumnia
perverts	pervertidos
unsteadily	inestablemente
despicable	despreciable
rusts	royas
oppressiveness	opresión
mishap	percance
insensitively	insensiblemente
outsmart	burlar
gimmick	truco
hells	infiernos
romanticize	romantizar
pittance	miseria
mistrustfully	desconfianza
respite	respiro
thrills	emociones
destruction	destrucción
distract	distraer
gravely	gravemente
resigned	resignado
enjoyable	agradable
oppressively	opresivamente
cringe	encogerse
stifle	ahogar
marveled	maravillado
giddy	mareado
breathlessness	disnea
rattled	sacudido
murder	asesinato
crumples	arruga
scarce	escaso
undone	deshecho
throttle	acelerador
troublemaker	alborotador
openness	franqueza
stalls	establos
useable	utilizable
spontaneous	natural
savvy	comprensión
obstructed	obstruido
bright	brillante
ultra-crisp	ultra-nítido
encroachment	usurpación
unhappy	infeliz
sinful	pecaminoso
leverage	apalancamiento
beautifully	hermosamente
tortured	torturado
suck	chupar
vagrant	vagabundo
corrupting	corruptor
scoundrel	canalla
suspicious	suspicaz
confession	confesión
usurper	usurpador
satirical	satírico
ultimatum	ultimátum
sourly	acritud
obscenity	obscenidad
hollow	hueco
indiscreetly	indiscretamente
spewing	vomitando
badly	mal
complaints	quejas
slaves	esclavos
woe	ay
taxing	agotador
blockbuster	superproducción
fascinating	fascinante
tout	revendedor
jubilantly	jubilosamente
guile	engaño
plagiarize	plagiar
hero	héroe
perplexing	confuso
obsessive	obsesionante
illegitimate	ilegítimo
timidity	timidez
indignation	indignación
wreaks	apesta
disdain	desdén
glorious	glorioso
extort	extorsionar
confounded	confundido
shameless	desvergonzado
protracted	prolongado
discountenance	desaprobar
overemphasize	enfatizar
smelly	maloliente
galls	agallas
apprehensive	aprensivo
pretentiously	pretenciosamente
goodly	hermoso
cure	cura
deadly	mortal
recklessly	imprudentemente
belittle	empequeñecer
moot	discutible
avenge	vengar
immoderate	inmoderado
jolly	alegre
complication	complicación
execrate	execrar
amuse	divertir
slowly	despacio
tarnish	empañar
luxuriously	lujosamente
dread	temer
egotistically	egoístamente
impress	impresionar
compactly	compacta
thirst	sed
reputation	reputación
immaterial	inmaterial
engrossing	absorbente
struggled	luchado
infamy	infamia
craps	dados
dangerousness	peligrosidad
warped	deformado
obtrusive	molesto
tyranny	tiranía
fortunately	afortunadamente
nervous	nervioso
involuntarily	involuntariamente
contention	contención
distraught	loco
exemplar	ejemplar
efficacious	eficaz
decrepitude	decrepitud
easiness	facilidad
mourner	doliente
sneering	despreciativos
unexpected	inesperado
consternation	consternación
shortsighted	miope
worriedly	preocupación
passive	pasivo
benevolence	benevolencia
imprecision	imprecisión
difficulty	dificultad
grievously	gravemente
traped	atrapado
admire	admirar
coarse	grueso
sloppily	descuidadamente
work	trabajo
drain	drenar
sunk	hundido
obsessiveness	obsesión
fancier	criador
stingy	tacaño
abound	abundar
unbelievable	increíble
scared	miedo
disgustful	repulsivas
cursed	maldito
edify	edificar
whiny	llorón
abusive	abusivo
throbs	latidos
grisly	espeluznante
disconsolation	desconsuelo
inventive	inventivo
euphoric	eufórico
slick	mancha
rancor	rencor
harbors	puertos
insignificant	insignificante
hang	caída
confessions	confesiones
bewitch	hechizar
fevers	fiebres
powerful	potente
straightforward	sencillo
cronyism	amiguismo
slump	depresión
criticized	criticado
apathy	apatía
harm	daño
devastates	arrasa
rankle	doler
devastation	devastación
mistaken	equivocado
entertains	entretiene
odor	olor
lousy	piojoso
transgress	transgredir
cataclysmically	cataclísmicamente
exasperate	exasperar
dumps	vertederos
lowly	humilde
eccentricity	excentricidad
insupportable	insoportable
privilege	privilegio
muscle-flexing	músculo-flexión
politeness	cortesía
invidiously	envidiosamente
stunned	aturdido
sweetly	dulcemente
enfeeble	debilitar
zaps	zapping
draconic	dracónica
immobilized	inmovilizado
scandals	escándalos
devastated	devastado
mawkishness	sensiblería
treacherous	traicionero
unrelenting	implacable
delays	retraso
droops	cae
infringement	infracción
bombardment	bombardeo
enjoy	disfrutar
tumbles	tumbos
tenderness	dolor
steadiness	firmeza
blithe	alegre
insolence	insolencia
adroit	hábil
stumble	tropezón
babble	balbuceo
drastic	drástico
snobby	snob
died	muerto
maladjustment	inadaptación
delight	deleite
succumb	sucumbir
byzantine	bizantino
merriness	alegría
delicate	delicado
enviable	envidiable
effortless	fácil
zeal	celo
frighten	asustar
haunting	obsesionante
effigy	efigie
puzzled	perplejo
accomplish	lograr
repel	repeler
inevitably	inevitablemente
unbeatable	insuperable
irrationalities	irracionalidades
inconsistency	inconsecuencia
wickedness	maldad
obstacle	obstáculo
defect	defecto
flimsy	endeble
discontinuity	discontinuidad
leak	fuga
womanizing	mujeriego
enraptured	embelesado
sardonic	sardónico
rust	herrumbre
sunken	hundido
beckoning	señas
exhaustion	agotamiento
inviolate	inviolado
fanatics	fanáticos
disturb	perturbar
pompous	pomposo
unsatisfactory	insatisfactorio
bitingly	mordazmente
falls	caídas
creaks	cruje
occludes	ocluye
cracks	grietas
compliant	obediente
furiously	furiosamente
perversely	perversamente
stunt	truco
offending	infractor
hardships	dificultades
extraordinary	extraordinario
excruciatingly	insoportablemente
stylish	elegante
fathomless	insondable
disgruntle	disgustar
inhumanity	inhumanidad
dastardly	ruin
fiction	ficción
unacceptably	inaceptablemente
betrayer	traidor
leaking	fugas
junky	adicto
truthful	veraz
bewildered	desconcertado
invigorating	vigorizante
rabid	rabioso
dislocated	dislocado
uphold	defender
prejudicial	perjudicial
remedy	remedio
cleanly	limpiamente
repugnantly	repugnantemente
lewdness	lascivia
outbursts	arrebatos
limited	limitado
complicated	complicado
respect	respeto
buzzing	zumbido
drag	arrastrar
acrimonious	mordaz
capably	competentemente
irritant	irritante
admiring	admirativo
astoundingly	pasmosamente
achievable	alcanzable
unspeakable	indecible
myth	mito
floundering	forcejeo
helplessness	impotencia
annoys	late
gallant	galante
gutter	canalón
creep	arrastrarse
believable	creíble
flashy	ostentoso
whores	putas
doomed	condenado
insensitivity	insensibilidad
vigilant	vigilante
dissatisfaction	insatisfacción
responsive	sensible
illusions	ilusiones
smelled	olido
distortion	distorsión
complement	complemento
gush	chorro
rumple	arrugar
breathtaking	asombroso
niggles	peros
infections	infecciones
blunders	errores
hotbeds	semilleros
disheartening	descorazonador
nourishing	nutritiva
puppets	marionetas
absence	ausencia
cutthroat	asesino
forfeit	perder
stellar	estelar
inundate	inundar
defeating	derrotar
loves	ama
imbroglio	embrollo
unwilling	reacio
unresolved	irresoluto
plunderer	saqueador
longing	anhelo
enviously	envidiosamente
regression	regresión
fear	miedo
indoctrination	adoctrinamiento
browbeat	atemorizar
zap	zas
daunting	desalentadora
contagious	contagioso
prohibitively	prohibitivamente
incredibly	increíblemente
bugs	insectos
annoyance	molestia
impious	impío
tetchy	irritable
refused	rechazado
massacre	matanza
ravage	destrozar
entertaining	entretenido
din	estruendo
expire	caducar
crippled	lisiado
bolster	reforzar
suppression	supresión
lack	falta
irresistibly	irresistiblemente
convincing	convincente
repulse	repulsión
accomodative	acomodativa
crippling	paralizante
bruise	contusión
adulterate	adulterar
distaste	disgusto
mistakenly	erróneamente
meager	exiguo
creeping	progresivo
harshly	duramente
wellbeing	bienestar
salutary	saludable
austere	austero
bumped	topado
angel	ángel
obtuse	obtuso
murky	turbio
discriminate	discriminar
peaceable	pacífico
impatient	impaciente
tardy	tardío
jubilate	jubilar
forged	falsificado
subjection	sujeción
encroach	usurpar
humiliating	humillante
castrated	castrado
spitefulness	malevolencia
disavowal	desautorización
respectfully	respetuosamente
smiling	sonriente
insufferably	insufriblemente
classic	clásico
unclear	claro
insinuate	insinuar
dismayingly	desalentadoramente
blister	ampolla
confusing	confuso
impressed	impresionado
notorious	notorio
blunder	disparate
dropout	deserción
grudges	rencores
unlucky	desafortunado
niggle	queja
delirium	delirio
nefariously	vilmente
unreasonably	excesivamente
disintegrate	desintegrarse
stupidest	estúpida
encouragement	estímulo
polution	contaminación
sarcastically	sarcásticamente
sagely	sabiamente
hallucinate	alucinar
